,chr,subpop,clus.id,start,end,peak,width
1,01K,all,01K_all_1,3495571,3499864,3495571,4293
2,01K,all,01K_all_2,7209499,7209863,7209863,364
3,01K,all,01K_all_3,8324892,8324927,8324892,35
4,01K,all,01K_all_4,13649735,13656953,13652695,7218
5,01K,all,01K_all_5,13669994,13670055,13669994,61
6,01K,all,01K_all_6,13670883,13672044,13671979,1161
7,01K,all,01K_all_7,13678872,13690688,13678872,11816
8,01K,all,01K_all_8,22421243,22422787,22421848,1544
9,01K,all,01K_all_9,23748279,23749186,23748279,907
10,01K,all,01K_all_10,23785983,23786337,23786337,354
11,01K,all,01K_all_11,23879137,23879589,23879137,452
12,01K,all,01K_all_12,23889197,23889607,23889607,410
13,01K,all,01K_all_13,25154466,25155086,25154466,620
14,01K,all,01K_all_14,25342986,25343990,25342986,1004
15,01K,all,01K_all_15,25592348,25594003,25592954,1655
16,01K,all,01K_all_16,25606463,25607256,25607256,793
17,01K,all,01K_all_17,25611980,25612984,25611980,1004
18,01K,all,01K_all_18,25617163,25618484,25618321,1321
19,01K,all,01K_all_19,25628313,25632004,25629939,3691
20,01K,all,01K_all_20,25634524,25635312,25635312,788
21,01K,all,01K_all_21,25636532,25638031,25636532,1499
22,01K,all,01K_all_22,25643085,25643176,25643085,91
23,01K,all,01K_all_23,25645435,25652736,25645435,7301
24,01K,all,01K_all_24,25653486,25654010,25653486,524
25,01K,all,01K_all_25,25656581,25657286,25656581,705
26,01K,all,01K_all_26,25658761,25660720,25660465,1959
27,01K,all,01K_all_27,25669864,25670520,25669864,656
28,01K,all,01K_all_28,25672161,25672615,25672560,454
29,01K,all,01K_all_29,25674063,25674824,25674063,761
30,01K,all,01K_all_30,25676757,25677172,25677172,415
31,01K,all,01K_all_31,25680075,25680137,25680075,62
32,01K,all,01K_all_32,25681602,25681875,25681875,273
33,01K,all,01K_all_33,25700017,25701178,25700337,1161
34,01K,all,01K_all_34,25702211,25704338,25704338,2127
35,01K,all,01K_all_35,25705487,25705501,25705487,14
36,01K,all,01K_all_36,25709230,25709811,25709811,581
37,01K,all,01K_all_37,25710670,25710874,25710670,204
38,01K,all,01K_all_38,25720698,25721363,25720983,665
39,01K,all,01K_all_39,25724228,25724470,25724470,242
40,01K,all,01K_all_40,25725528,25726860,25725528,1332
41,01K,all,01K_all_41,25734214,25734506,25734214,292
42,01K,all,01K_all_42,25845186,25845877,25845877,691
43,01K,all,01K_all_43,25846448,25846707,25846514,259
44,01K,all,01K_all_44,25848488,25856046,25848678,7558
45,01K,all,01K_all_45,25858133,25858392,25858133,259
46,01K,all,01K_all_46,25859674,25859719,25859719,45
47,01K,all,01K_all_47,25865107,25867579,25867368,2472
48,01K,all,01K_all_48,25868494,25870369,25869760,1875
49,01K,all,01K_all_49,25871249,25873074,25872012,1825
50,01K,all,01K_all_50,25874773,25875651,25875225,878
51,01K,all,01K_all_51,25876646,25876841,25876841,195
52,01K,all,01K_all_52,25885171,25890557,25886944,5386
53,01K,all,01K_all_53,25892412,25893421,25892475,1009
54,01K,all,01K_all_54,25895572,25898963,25898963,3391
55,01K,all,01K_all_55,25901253,25907549,25907158,6296
56,01K,all,01K_all_56,25909426,25910142,25909426,716
57,01K,all,01K_all_57,25929771,25930907,25930445,1136
58,01K,all,01K_all_58,25933790,25936229,25936194,2439
59,01K,all,01K_all_59,25938210,25939050,25939050,840
60,01K,all,01K_all_60,25940209,25940902,25940902,693
61,01K,all,01K_all_61,25956275,25956715,25956275,440
62,01K,all,01K_all_62,25959679,25960099,25960099,420
63,01K,all,01K_all_63,25961345,25964014,25961812,2669
64,01K,all,01K_all_64,25976778,25978796,25978796,2018
65,01K,all,01K_all_65,25988912,25991171,25990192,2259
66,01K,all,01K_all_66,25992627,25992902,25992627,275
67,01K,all,01K_all_67,26011364,26011727,26011364,363
68,01K,all,01K_all_68,26014998,26016021,26015665,1023
69,01K,all,01K_all_69,26042722,26042834,26042722,112
70,01K,all,01K_all_70,26087999,26090696,26090696,2697
71,01K,all,01K_all_71,26094956,26095612,26094956,656
72,01K,all,01K_all_72,26097200,26099209,26097200,2009
73,01K,all,01K_all_73,26160804,26160866,26160866,62
74,01K,all,01K_all_74,26185898,26188062,26188062,2164
75,01K,all,01K_all_75,26191439,26191918,26191439,479
76,01K,all,01K_all_76,26192846,26193178,26193100,332
77,01K,all,01K_all_77,26234690,26235124,26235124,434
78,01K,all,01K_all_78,26237336,26238399,26238399,1063
79,01K,all,01K_all_79,26241433,26243103,26243103,1670
80,01K,all,01K_all_80,26249200,26251975,26250321,2775
81,01K,all,01K_all_81,26253231,26253482,26253482,251
82,01K,all,01K_all_82,26256077,26258976,26256767,2899
83,01K,all,01K_all_83,26260125,26260768,26260125,643
84,01K,all,01K_all_84,26271005,26271030,26271030,25
85,01K,all,01K_all_85,26281749,26282773,26281795,1024
86,01K,all,01K_all_86,26283837,26284264,26284264,427
87,01K,all,01K_all_87,26304700,26315161,26314632,10461
88,01K,all,01K_all_88,26318823,26318951,26318823,128
89,01K,all,01K_all_89,26320408,26321263,26321263,855
90,01K,all,01K_all_90,26323481,26324758,26323931,1277
91,01K,all,01K_all_91,26328422,26328486,26328486,64
92,01K,all,01K_all_92,26330818,26333634,26331789,2816
93,01K,all,01K_all_93,26335166,26336749,26335166,1583
94,01K,all,01K_all_94,26344268,26355068,26347197,10800
95,01K,all,01K_all_95,26358947,26359174,26358947,227
96,01K,all,01K_all_96,26363836,26365660,26363836,1824
97,01K,all,01K_all_97,26371333,26373039,26373039,1706
98,01K,all,01K_all_98,26375237,26387562,26375237,12325
99,01K,all,01K_all_99,26391529,26393976,26392792,2447
100,01K,all,01K_all_100,26395758,26396885,26395796,1127
101,01K,all,01K_all_101,26403564,26406880,26405726,3316
102,01K,all,01K_all_102,26410044,26414298,26412187,4254
103,01K,all,01K_all_103,26416320,26418435,26417812,2115
104,01K,all,01K_all_104,26422609,26424892,26424002,2283
105,01K,all,01K_all_105,26427494,26431778,26430933,4284
106,01K,all,01K_all_106,26435811,26438074,26437851,2263
107,01K,all,01K_all_107,26438938,26441370,26440870,2432
108,01K,all,01K_all_108,26442567,26443167,26442809,600
109,01K,all,01K_all_109,26444485,26448671,26448084,4186
110,01K,all,01K_all_110,26467495,26471346,26469782,3851
111,01K,all,01K_all_111,26473034,26485748,26479618,12714
112,01K,all,01K_all_112,26494767,26495778,26495778,1011
113,01K,all,01K_all_113,26497327,26500236,26497761,2909
114,01K,all,01K_all_114,26501281,26502905,26502168,1624
115,01K,all,01K_all_115,26505086,26508389,26505086,3303
116,01K,all,01K_all_116,26530436,26530967,26530967,531
117,01K,all,01K_all_117,26533560,26535368,26535187,1808
118,01K,all,01K_all_118,26573064,26573752,26573064,688
119,01K,all,01K_all_119,26582495,26588709,26586324,6214
120,01K,all,01K_all_120,26591361,26592976,26592976,1615
121,01K,all,01K_all_121,33388870,33389116,33388932,246
122,01K,all,01K_all_122,34924873,34928406,34924873,3533
123,01K,all,01K_all_123,37264519,37273096,37264530,8577
124,01K,all,01K_all_124,38130922,38132557,38130922,1635
125,01K,all,01K_all_125,42099219,42099526,42099311,307
126,01K,all,01K_all_126,44748980,44749473,44749473,493
127,01K,all,01K_all_127,44755977,44756517,44755977,540
128,01K,all,01K_all_128,44780101,44780487,44780101,386
129,01K,all,01K_all_129,45166268,45166549,45166409,281
130,01K,all,01K_all_130,45389786,45390711,45389786,925
131,01K,all,01K_all_131,45393271,45393327,45393327,56
132,01K,all,01K_all_132,51336038,51336635,51336635,597
133,01K,all,01K_all_133,51337434,51337615,51337434,181
134,01K,all,01K_all_134,51339322,51339981,51339567,659
135,01K,all,01K_all_135,51592778,51592779,51592778,1
136,01K,all,01K_all_136,51636419,51637678,51636419,1259
137,01K,all,01K_all_137,51642902,51644469,51644469,1567
138,01K,all,01K_all_138,51719675,51720060,51720060,385
139,01K,all,01K_all_139,51728407,51740737,51731219,12330
140,01K,all,01K_all_140,51795964,51797446,51795964,1482
141,01K,all,01K_all_141,52401850,52402741,52402741,891
142,01K,all,01K_all_142,52915764,52916358,52915764,594
143,01K,all,01K_all_143,53242746,53243402,53242746,656
144,01K,all,01K_all_144,54030222,54030801,54030222,579
145,01K,all,01K_all_145,54556986,54559391,54559391,2405
146,01N,all,01N_all_1,1059639,1059705,1059705,66
147,01N,all,01N_all_2,1072998,1073397,1072998,399
148,01N,all,01N_all_3,3099909,3099916,3099909,7
149,01N,all,01N_all_4,12534178,12534192,12534178,14
150,01N,all,01N_all_5,13387412,13391364,13391364,3952
151,01N,all,01N_all_6,13394208,13395070,13394979,862
152,01N,all,01N_all_7,13396840,13399568,13399568,2728
153,01N,all,01N_all_8,13400857,13402821,13401591,1964
154,01N,all,01N_all_9,13845944,13851033,13847247,5089
155,01N,all,01N_all_10,15099054,15099069,15099069,15
156,01N,all,01N_all_11,22024286,22031892,22024286,7606
157,01N,all,01N_all_12,22038537,22040590,22038537,2053
158,01N,all,01N_all_13,22238839,22257558,22256037,18719
159,01N,all,01N_all_14,22336600,22339187,22339187,2587
160,01N,all,01N_all_15,22773466,22800016,22797828,26550
161,01N,all,01N_all_16,22810859,22810910,22810859,51
162,01N,all,01N_all_17,22834271,22840674,22839225,6403
163,01N,all,01N_all_18,22842378,22845335,22845325,2957
164,01N,all,01N_all_19,22846116,22847935,22847888,1819
165,01N,all,01N_all_20,23002555,23002806,23002806,251
166,01N,all,01N_all_21,23160854,23163725,23163725,2871
167,01N,all,01N_all_22,23170202,23170282,23170202,80
168,01N,all,01N_all_23,23196221,23211530,23211530,15309
169,01N,all,01N_all_24,23363001,23363180,23363180,179
170,01N,all,01N_all_25,23377129,23377171,23377171,42
171,01N,all,01N_all_26,23409744,23413396,23412976,3652
172,01N,all,01N_all_27,23479393,23480943,23480943,1550
173,01N,all,01N_all_28,23483054,23484153,23483054,1099
174,01N,all,01N_all_29,23487395,23487750,23487750,355
175,01N,all,01N_all_30,23490136,23494647,23494451,4511
176,01N,all,01N_all_31,23496493,23497340,23496759,847
177,01N,all,01N_all_32,23510509,23525961,23513809,15452
178,01N,all,01N_all_33,23527520,23532870,23531650,5350
179,01N,all,01N_all_34,23538783,23539289,23538783,506
180,01N,all,01N_all_35,23540325,23567909,23556269,27584
181,01N,all,01N_all_36,23992432,23995408,23993545,2976
182,01N,all,01N_all_37,24149212,24149762,24149620,550
183,01N,all,01N_all_38,24592347,24598439,24594825,6092
184,01N,all,01N_all_39,24600118,24607919,24601359,7801
185,01N,all,01N_all_40,24620532,24648366,24620603,27834
186,01N,all,01N_all_41,24651075,24689368,24659871,38293
187,01N,all,01N_all_42,24690638,24715548,24707432,24910
188,01N,all,01N_all_43,24740418,24762620,24762192,22202
189,01N,all,01N_all_44,24869862,24870592,24870103,730
190,01N,all,01N_all_45,24875941,24880255,24875941,4314
191,01N,all,01N_all_46,25076699,25076868,25076868,169
192,01N,all,01N_all_47,25109187,25109448,25109187,261
193,01N,all,01N_all_48,25286279,25286877,25286279,598
194,01N,all,01N_all_49,25368915,25371326,25368962,2411
195,01N,all,01N_all_50,25485467,25492373,25492372,6906
196,01N,all,01N_all_51,25493122,25493572,25493149,450
197,01N,all,01N_all_52,25509938,25519414,25517606,9476
198,01N,all,01N_all_53,25533662,25552653,25544257,18991
199,01N,all,01N_all_54,25574166,25606893,25604879,32727
200,01N,all,01N_all_55,25674228,25683460,25681343,9232
201,01N,all,01N_all_56,25707817,25727752,25721658,19935
202,01N,all,01N_all_57,25728756,25728852,25728852,96
203,01N,all,01N_all_58,25731435,25760099,25731435,28664
204,01N,all,01N_all_59,25761121,25763707,25761533,2586
205,01N,all,01N_all_60,25766554,25771967,25768019,5413
206,01N,all,01N_all_61,25786101,25816722,25809208,30621
207,01N,all,01N_all_62,25818953,25821430,25819693,2477
208,01N,all,01N_all_63,25831156,25867129,25852384,35973
209,01N,all,01N_all_64,25875441,25883354,25878323,7913
210,01N,all,01N_all_65,25890523,25891420,25890930,897
211,01N,all,01N_all_66,25894134,25900411,25899624,6277
212,01N,all,01N_all_67,25922326,25925284,25924668,2958
213,01N,all,01N_all_68,25926773,25926861,25926773,88
214,01N,all,01N_all_69,25927596,25929113,25928422,1517
215,01N,all,01N_all_70,25930307,25936046,25931324,5739
216,01N,all,01N_all_71,25937150,25950338,25938985,13188
217,01N,all,01N_all_72,25953051,25956696,25953637,3645
218,01N,all,01N_all_73,25973152,25979599,25974320,6447
219,01N,all,01N_all_74,25980990,25987425,25986579,6435
220,01N,all,01N_all_75,25990677,25991865,25991865,1188
221,01N,all,01N_all_76,25992860,25996510,25996225,3650
222,01N,all,01N_all_77,25997770,26027672,26020574,29902
223,01N,all,01N_all_78,26029809,26031587,26029823,1778
224,01N,all,01N_all_79,26034332,26066771,26038154,32439
225,01N,all,01N_all_80,26071993,26086838,26084641,14845
226,01N,all,01N_all_81,26091044,26097375,26095647,6331
227,01N,all,01N_all_82,26098094,26131965,26098399,33871
228,01N,all,01N_all_83,26132995,26134018,26134018,1023
229,01N,all,01N_all_84,26247201,26257165,26254087,9964
230,01N,all,01N_all_85,26264954,26286112,26283906,21158
231,01N,all,01N_all_86,26371712,26372183,26372067,471
232,01N,all,01N_all_87,26373252,26414839,26413911,41587
233,01N,all,01N_all_88,26416794,26417475,26417475,681
234,01N,all,01N_all_89,26447967,26467821,26467821,19854
235,01N,all,01N_all_90,26524659,26533465,26532020,8806
236,01N,all,01N_all_91,26721437,26721700,26721700,263
237,01N,all,01N_all_92,26768223,26779304,26771841,11081
238,01N,all,01N_all_93,27016411,27101383,27062748,84972
239,01N,all,01N_all_94,27102180,27103632,27102822,1452
240,01N,all,01N_all_95,27164899,27170108,27168846,5209
241,01N,all,01N_all_96,27200580,27202862,27201467,2282
242,01N,all,01N_all_97,27357553,27363192,27363192,5639
243,01N,all,01N_all_98,27555700,27556289,27555700,589
244,01N,all,01N_all_99,27614993,27629093,27628748,14100
245,01N,all,01N_all_100,27632001,27666744,27655216,34743
246,01N,all,01N_all_101,27667939,27698467,27696182,30528
247,01N,all,01N_all_102,27699209,27746907,27745024,47698
248,01N,all,01N_all_103,27749221,27757629,27751327,8408
249,01N,all,01N_all_104,27764074,27799849,27767080,35775
250,01N,all,01N_all_105,27800716,27885833,27882397,85117
251,01N,all,01N_all_106,27901349,27921402,27919185,20053
252,01N,all,01N_all_107,27960438,27962075,27960449,1637
253,01N,all,01N_all_108,27964148,27980074,27972583,15926
254,01N,all,01N_all_109,27984269,27984279,27984279,10
255,01N,all,01N_all_110,27986092,27986967,27986092,875
256,01N,all,01N_all_111,27988785,27990765,27990765,1980
257,01N,all,01N_all_112,27992579,27992787,27992787,208
258,01N,all,01N_all_113,27994531,27995422,27994531,891
259,01N,all,01N_all_114,27996568,28000071,28000071,3503
260,01N,all,01N_all_115,28001837,28003701,28002079,1864
261,01N,all,01N_all_116,28018963,28020107,28020107,1144
262,01N,all,01N_all_117,28021406,28021746,28021406,340
263,01N,all,01N_all_118,28054539,28055376,28055376,837
264,01N,all,01N_all_119,28115184,28116226,28115953,1042
265,01N,all,01N_all_120,28138265,28138525,28138525,260
266,01N,all,01N_all_121,28153913,28161155,28161155,7242
267,01N,all,01N_all_122,28207888,28210118,28209595,2230
268,01N,all,01N_all_123,28221658,28222485,28222485,827
269,01N,all,01N_all_124,28224135,28224784,28224250,649
270,01N,all,01N_all_125,28225689,28226243,28225689,554
271,01N,all,01N_all_126,28227033,28227326,28227033,293
272,01N,all,01N_all_127,28228077,28228639,28228639,562
273,01N,all,01N_all_128,28230628,28233720,28230628,3092
274,01N,all,01N_all_129,28238916,28239278,28238916,362
275,01N,all,01N_all_130,28242147,28242339,28242147,192
276,01N,all,01N_all_131,28263766,28267540,28264984,3774
277,01N,all,01N_all_132,28277376,28280962,28280165,3586
278,01N,all,01N_all_133,28282313,28282799,28282313,486
279,01N,all,01N_all_134,28284535,28294050,28294050,9515
280,01N,all,01N_all_135,28295469,28296198,28295469,729
281,01N,all,01N_all_136,28297648,28298701,28297649,1053
282,01N,all,01N_all_137,28299670,28300956,28300956,1286
283,01N,all,01N_all_138,28302931,28303260,28303260,329
284,01N,all,01N_all_139,28307351,28320585,28311183,13234
285,01N,all,01N_all_140,28343373,28343540,28343540,167
286,01N,all,01N_all_141,28359478,28359516,28359516,38
287,01N,all,01N_all_142,28360251,28360691,28360251,440
288,01N,all,01N_all_143,28363418,28365008,28365008,1590
289,01N,all,01N_all_144,28365929,28369016,28366064,3087
290,01N,all,01N_all_145,28382004,28385160,28385160,3156
291,01N,all,01N_all_146,28388663,28392278,28390968,3615
292,01N,all,01N_all_147,28404940,28405954,28405954,1014
293,01N,all,01N_all_148,28408189,28412446,28412446,4257
294,01N,all,01N_all_149,28415272,28422251,28422251,6979
295,01N,all,01N_all_150,28425934,28426183,28426183,249
296,01N,all,01N_all_151,28435992,28438264,28435992,2272
297,01N,all,01N_all_152,28439815,28446071,28440200,6256
298,01N,all,01N_all_153,28448029,28448101,28448029,72
299,01N,all,01N_all_154,28449449,28449470,28449449,21
300,01N,all,01N_all_155,28477983,28478773,28478219,790
301,01N,all,01N_all_156,28479900,28480269,28480269,369
302,01N,all,01N_all_157,28482539,28485226,28484932,2687
303,01N,all,01N_all_158,28487957,28491073,28488208,3116
304,01N,all,01N_all_159,28492107,28495349,28493031,3242
305,01N,all,01N_all_160,28527047,28537446,28537446,10399
306,01N,all,01N_all_161,28552758,28554399,28552758,1641
307,01N,all,01N_all_162,28565059,28567122,28565834,2063
308,01N,all,01N_all_163,28575197,28578158,28578158,2961
309,01N,all,01N_all_164,28579580,28580073,28579580,493
310,01N,all,01N_all_165,28582726,28584587,28584521,1861
311,01N,all,01N_all_166,28587735,28588611,28588611,876
312,01N,all,01N_all_167,28590730,28591201,28590730,471
313,01N,all,01N_all_168,28592169,28592364,28592202,195
314,01N,all,01N_all_169,28595303,28595788,28595303,485
315,01N,all,01N_all_170,28597507,28597897,28597507,390
316,01N,all,01N_all_171,28611647,28613001,28611647,1354
317,01N,all,01N_all_172,28613793,28614263,28613940,470
318,01N,all,01N_all_173,28618069,28618625,28618069,556
319,01N,all,01N_all_174,28626709,28627335,28626709,626
320,01N,all,01N_all_175,28630223,28630233,28630223,10
321,01N,all,01N_all_176,28634596,28635561,28635515,965
322,01N,all,01N_all_177,28645843,28646399,28645843,556
323,01N,all,01N_all_178,28647757,28648418,28648418,661
324,01N,all,01N_all_179,28655539,28659500,28659374,3961
325,01N,all,01N_all_180,28660340,28660367,28660367,27
326,01N,all,01N_all_181,28663560,28676637,28676637,13077
327,01N,all,01N_all_182,28678301,28678408,28678408,107
328,01N,all,01N_all_183,28682015,28682903,28682903,888
329,01N,all,01N_all_184,28684521,28686645,28684521,2124
330,01N,all,01N_all_185,28688347,28700017,28700017,11670
331,01N,all,01N_all_186,28703709,28704913,28704123,1204
332,01N,all,01N_all_187,28708174,28714508,28714508,6334
333,01N,all,01N_all_188,28716376,28717369,28716697,993
334,01N,all,01N_all_189,28723984,28724192,28724192,208
335,01N,all,01N_all_190,28725609,28726904,28725917,1295
336,01N,all,01N_all_191,28729477,28739843,28730078,10366
337,01N,all,01N_all_192,28742950,28743848,28743848,898
338,01N,all,01N_all_193,28747938,28760976,28757908,13038
339,01N,all,01N_all_194,28772299,28782430,28782430,10131
340,01N,all,01N_all_195,28783590,28785577,28784390,1987
341,01N,all,01N_all_196,28786590,28787178,28786820,588
342,01N,all,01N_all_197,28802748,28804344,28802748,1596
343,01N,all,01N_all_198,28862257,28863826,28863344,1569
344,01N,all,01N_all_199,29111332,29113360,29111332,2028
345,01N,all,01N_all_200,29136545,29137125,29137125,580
346,01N,all,01N_all_201,29154636,29155062,29155062,426
347,01N,all,01N_all_202,29174487,29175188,29174487,701
348,01N,all,01N_all_203,30486439,30486895,30486859,456
349,01N,all,01N_all_204,30519851,30519982,30519851,131
350,01N,all,01N_all_205,30649771,30650244,30650244,473
351,01N,all,01N_all_206,31078888,31080093,31079165,1205
352,01N,all,01N_all_207,31296033,31300821,31299602,4788
353,01N,all,01N_all_208,31309738,31313956,31310711,4218
354,01N,all,01N_all_209,31327031,31334462,31329845,7431
355,01N,all,01N_all_210,31337846,31393967,31385316,56121
356,01N,all,01N_all_211,31394496,31401429,31401429,6933
357,01N,all,01N_all_212,31403978,31416170,31412110,12192
358,01N,all,01N_all_213,31417607,31433928,31418325,16321
359,01N,all,01N_all_214,31435168,31438284,31437183,3116
360,01N,all,01N_all_215,31459794,31477642,31470212,17848
361,01N,all,01N_all_216,31479203,31481469,31481469,2266
362,01N,all,01N_all_217,31483276,31491255,31490562,7979
363,01N,all,01N_all_218,31492439,31518140,31492456,25701
364,01N,all,01N_all_219,31571805,31571858,31571858,53
365,01N,all,01N_all_220,31594402,31623103,31616698,28701
366,01N,all,01N_all_221,31625150,31628980,31628980,3830
367,01N,all,01N_all_222,31630674,31632812,31632676,2138
368,01N,all,01N_all_223,31644551,31662520,31650843,17969
369,01N,all,01N_all_224,31663541,31671608,31663644,8067
370,01N,all,01N_all_225,31697586,31744966,31733509,47380
371,01N,all,01N_all_226,31745867,31747020,31746470,1153
372,01N,all,01N_all_227,31748045,31769568,31748494,21523
373,01N,all,01N_all_228,31798170,31874480,31846132,76310
374,01N,all,01N_all_229,31876403,31878047,31876856,1644
375,01N,all,01N_all_230,31886528,31899525,31890034,12997
376,01N,all,01N_all_231,31914183,31920955,31919064,6772
377,01N,all,01N_all_232,31986580,31990183,31989018,3603
378,01N,all,01N_all_233,32011276,32042043,32012748,30767
379,01N,all,01N_all_234,32059374,32063754,32059374,4380
380,01N,all,01N_all_235,32071538,32074740,32071902,3202
381,01N,all,01N_all_236,32075500,32080634,32076634,5134
382,01N,all,01N_all_237,32094859,32096172,32096172,1313
383,01N,all,01N_all_238,32096860,32104234,32103115,7374
384,01N,all,01N_all_239,32123312,32130125,32127591,6813
385,01N,all,01N_all_240,32135541,32136193,32136193,652
386,01N,all,01N_all_241,32159788,32203994,32165933,44206
387,01N,all,01N_all_242,32231078,32234100,32231379,3022
388,01N,all,01N_all_243,32254244,32270889,32270215,16645
389,01N,all,01N_all_244,32272101,32317817,32293224,45716
390,01N,all,01N_all_245,32330743,32381700,32381563,50957
391,01N,all,01N_all_246,32406620,32445251,32411673,38631
392,01N,all,01N_all_247,32447642,32448050,32448050,408
393,01N,all,01N_all_248,32450898,32455591,32452612,4693
394,01N,all,01N_all_249,32460819,32499207,32462991,38388
395,01N,all,01N_all_250,32524394,32525218,32524543,824
396,01N,all,01N_all_251,32586395,32587825,32587825,1430
397,01N,all,01N_all_252,32678188,32682656,32681182,4468
398,01N,all,01N_all_253,32695351,32696425,32696425,1074
399,01N,all,01N_all_254,32768392,32768478,32768478,86
400,01N,all,01N_all_255,32815462,32834974,32815479,19512
401,01N,all,01N_all_256,32836912,32837348,32836912,436
402,01N,all,01N_all_257,32840851,32841639,32840851,788
403,01N,all,01N_all_258,32843775,32844924,32844924,1149
404,01N,all,01N_all_259,32849280,32849631,32849280,351
405,01N,all,01N_all_260,32863429,32864665,32864665,1236
406,01N,all,01N_all_261,32866785,32867210,32866785,425
407,01N,all,01N_all_262,32870363,32872223,32871089,1860
408,01N,all,01N_all_263,32875177,32881729,32875385,6552
409,01N,all,01N_all_264,32944916,32947207,32945626,2291
410,01N,all,01N_all_265,32950722,32952041,32950722,1319
411,01N,all,01N_all_266,32953431,32954882,32954816,1451
412,01N,all,01N_all_267,32976223,32976695,32976257,472
413,01N,all,01N_all_268,32978277,32979752,32978848,1475
414,01N,all,01N_all_269,32984275,32994491,32994491,10216
415,01N,all,01N_all_270,33008591,33011502,33008591,2911
416,01N,all,01N_all_271,33016721,33019098,33016721,2377
417,01N,all,01N_all_272,33020568,33033090,33033090,12522
418,01N,all,01N_all_273,33038704,33040215,33040135,1511
419,01N,all,01N_all_274,33044331,33049388,33048474,5057
420,01N,all,01N_all_275,33050132,33051875,33051535,1743
421,01N,all,01N_all_276,33052644,33058078,33053342,5434
422,01N,all,01N_all_277,33299774,33300843,33299774,1069
423,01N,all,01N_all_278,33317187,33318138,33317187,951
424,01N,all,01N_all_279,33532552,33541846,33541567,9294
425,01N,all,01N_all_280,33544715,33545588,33544715,873
426,01N,all,01N_all_281,33547859,33548552,33547859,693
427,01N,all,01N_all_282,33550087,33552396,33552396,2309
428,01N,all,01N_all_283,33553924,33554880,33554880,956
429,01N,all,01N_all_284,33559921,33561101,33560282,1180
430,01N,all,01N_all_285,33563984,33564229,33563984,245
431,01N,all,01N_all_286,33592835,33593062,33593062,227
432,01N,all,01N_all_287,33593998,33596112,33593998,2114
433,01N,all,01N_all_288,33599895,33603896,33600868,4001
434,01N,all,01N_all_289,33605425,33607871,33607412,2446
435,01N,all,01N_all_290,33608794,33609757,33609103,963
436,01N,all,01N_all_291,33654848,33657252,33656006,2404
437,01N,all,01N_all_292,33685107,33686961,33686961,1854
438,01N,all,01N_all_293,33687800,33689184,33687831,1384
439,01N,all,01N_all_294,33690882,33690925,33690882,43
440,01N,all,01N_all_295,33691603,33692833,33692833,1230
441,01N,all,01N_all_296,33696685,33697142,33696685,457
442,01N,all,01N_all_297,33700311,33702883,33700311,2572
443,01N,all,01N_all_298,33704266,33704509,33704266,243
444,01N,all,01N_all_299,33706310,33706940,33706310,630
445,01N,all,01N_all_300,33730401,33730971,33730620,570
446,01N,all,01N_all_301,33731778,33733146,33732069,1368
447,01N,all,01N_all_302,33733993,33734239,33734239,246
448,01N,all,01N_all_303,33757848,33758282,33758282,434
449,01N,all,01N_all_304,33763837,33764940,33764940,1103
450,01N,all,01N_all_305,33766082,33766101,33766101,19
451,01N,all,01N_all_306,33780353,33780670,33780353,317
452,01N,all,01N_all_307,33801077,33801900,33801900,823
453,01N,all,01N_all_308,33802648,33803158,33803158,510
454,01N,all,01N_all_309,33804489,33805686,33804707,1197
455,01N,all,01N_all_310,33809323,33810569,33809365,1246
456,01N,all,01N_all_311,33812192,33813173,33813173,981
457,01N,all,01N_all_312,33814784,33816325,33814784,1541
458,01N,all,01N_all_313,33866250,33866357,33866250,107
459,01N,all,01N_all_314,34833959,34833989,34833989,30
460,01N,all,01N_all_315,34836761,34839391,34837370,2630
461,01N,all,01N_all_316,34876466,34915074,34908379,38608
462,01N,all,01N_all_317,34917537,34917942,34917942,405
463,01N,all,01N_all_318,35954684,35955479,35954684,795
464,01N,all,01N_all_319,41799588,41800347,41799588,759
465,01N,all,01N_all_320,42987440,42993707,42993606,6267
466,01N,all,01N_all_321,43060073,43060836,43060836,763
467,01N,all,01N_all_322,45348007,45348536,45348048,529
468,01N,all,01N_all_323,47483384,47485361,47484961,1977
469,01N,all,01N_all_324,47487564,47487822,47487564,258
470,01N,all,01N_all_325,47488995,47489137,47488995,142
471,01N,all,01N_all_326,47493522,47493572,47493526,50
472,01N,all,01N_all_327,47860170,47861086,47860170,916
473,01N,all,01N_all_328,47893752,47894212,47894212,460
474,01N,all,01N_all_329,47896220,47897553,47897553,1333
475,01N,all,01N_all_330,49792128,49792251,49792251,123
476,01N,all,01N_all_331,50028300,50028423,50028300,123
477,01N,all,01N_all_332,51117057,51117078,51117057,21
478,01N,all,01N_all_333,51620367,51620395,51620367,28
479,01N,all,01N_all_334,52858528,52860029,52860029,1501
480,01N,all,01N_all_335,52877726,52878154,52877726,428
481,01N,all,01N_all_336,52904077,52904244,52904077,167
482,01N,all,01N_all_337,52906754,52906761,52906761,7
483,01N,all,01N_all_338,52924518,52925313,52925301,795
484,01N,all,01N_all_339,52926965,52930519,52928214,3554
485,01N,all,01N_all_340,52931936,52936973,52932996,5037
486,01N,all,01N_all_341,52940818,52940826,52940826,8
487,01N,all,01N_all_342,52956079,52956162,52956162,83
488,01N,all,01N_all_343,55089337,55089803,55089391,466
489,01N,all,01N_all_344,55581498,55583890,55582664,2392
490,01N,all,01N_all_345,55676851,55683651,55677446,6800
491,01N,all,01N_all_346,55685545,55687316,55687316,1771
492,01N,all,01N_all_347,56504845,56523845,56522816,19000
493,01N,all,01N_all_348,56780496,56784067,56781062,3571
494,01N,all,01N_all_349,57316266,57316565,57316451,299
495,01N,all,01N_all_350,57364820,57365784,57365784,964
496,01N,all,01N_all_351,57368003,57368174,57368003,171
497,01N,all,01N_all_352,57492774,57500557,57499561,7783
498,01N,all,01N_all_353,57768207,57768403,57768403,196
499,01N,all,01N_all_354,58387010,58388459,58387305,1449
500,01N,all,01N_all_355,58391147,58392494,58392494,1347
501,01N,all,01N_all_356,59214903,59215029,59215029,126
502,01N,all,01N_all_357,61585648,61585696,61585696,48
503,01N,all,01N_all_358,62544844,62544969,62544969,125
504,01N,all,01N_all_359,62545821,62545882,62545821,61
505,01N,all,01N_all_360,63797327,63798155,63798155,828
506,01N,all,01N_all_361,66780021,66782334,66780388,2313
507,01N,all,01N_all_362,66785137,66791103,66785137,5966
508,01N,all,01N_all_363,66837270,66840531,66837462,3261
509,01N,all,01N_all_364,66853076,66859988,66856174,6912
510,01N,all,01N_all_365,66889040,66892846,66890222,3806
511,01N,all,01N_all_366,66963785,66963951,66963951,166
512,01N,all,01N_all_367,66990898,66991305,66990898,407
513,01N,all,01N_all_368,66992611,66994793,66994285,2182
514,01N,all,01N_all_369,66996401,66999867,66996401,3466
515,02K,all,02K_all_1,3190403,3190739,3190637,336
516,02K,all,02K_all_2,4075972,4076053,4076053,81
517,02K,all,02K_all_3,4227243,4229590,4227243,2347
518,02K,all,02K_all_4,4468832,4469021,4469021,189
519,02K,all,02K_all_5,5269799,5269845,5269799,46
520,02K,all,02K_all_6,13338562,13339766,13338562,1204
521,02K,all,02K_all_7,22194020,22194341,22194341,321
522,02K,all,02K_all_8,22559984,22560084,22560084,100
523,02K,all,02K_all_9,22561582,22561605,22561605,23
524,02K,all,02K_all_10,23031170,23031409,23031409,239
525,02K,all,02K_all_11,23035120,23035211,23035120,91
526,02K,all,02K_all_12,23089837,23090736,23090389,899
527,02K,all,02K_all_13,23096206,23097657,23096206,1451
528,02K,all,02K_all_14,23098381,23099548,23099548,1167
529,02K,all,02K_all_15,23100104,23100367,23100104,263
530,02K,all,02K_all_16,23101151,23102012,23101613,861
531,02K,all,02K_all_17,23119363,23121017,23121017,1654
532,02K,all,02K_all_18,23128500,23129963,23129512,1463
533,02K,all,02K_all_19,23153492,23153703,23153492,211
534,02K,all,02K_all_20,23156392,23157090,23157090,698
535,02K,all,02K_all_21,23162553,23163184,23162623,631
536,02K,all,02K_all_22,23269251,23269258,23269251,7
537,02K,all,02K_all_23,23384533,23385825,23384634,1292
538,02K,all,02K_all_24,23391335,23391681,23391335,346
539,02K,all,02K_all_25,23393178,23393794,23393588,616
540,02K,all,02K_all_26,23394832,23395762,23394832,930
541,02K,all,02K_all_27,23445461,23445527,23445527,66
542,02K,all,02K_all_28,23449482,23453120,23450839,3638
543,02K,all,02K_all_29,23481133,23483102,23481450,1969
544,02K,all,02K_all_30,23923542,23923723,23923723,181
545,02K,all,02K_all_31,24613713,24616581,24615360,2868
546,02K,all,02K_all_32,24646806,24646807,24646807,1
547,02K,all,02K_all_33,24648912,24654073,24650617,5161
548,02K,all,02K_all_34,24656300,24657902,24657902,1602
549,02K,all,02K_all_35,24660236,24662669,24660236,2433
550,02K,all,02K_all_36,25749948,25758741,25749948,8793
551,02K,all,02K_all_37,25782487,25785249,25783167,2762
552,02K,all,02K_all_38,25792971,25793279,25793279,308
553,02K,all,02K_all_39,25795573,25796559,25795929,986
554,02K,all,02K_all_40,25797845,25797934,25797845,89
555,02K,all,02K_all_41,25799277,25800531,25799494,1254
556,02K,all,02K_all_42,25805139,25805619,25805619,480
557,02K,all,02K_all_43,25807504,25808344,25807504,840
558,02K,all,02K_all_44,25833878,25833948,25833878,70
559,02K,all,02K_all_45,25836271,25839462,25837997,3191
560,02K,all,02K_all_46,25864557,25865636,25864557,1079
561,02K,all,02K_all_47,25866700,25866962,25866962,262
562,02K,all,02K_all_48,25867527,25867699,25867699,172
563,02K,all,02K_all_49,25868167,25868645,25868645,478
564,02K,all,02K_all_50,25870340,25871685,25871685,1345
565,02K,all,02K_all_51,25872263,25872513,25872513,250
566,02K,all,02K_all_52,25892635,25894144,25892821,1509
567,02K,all,02K_all_53,25910937,25911518,25911518,581
568,02K,all,02K_all_54,25915556,25916093,25915556,537
569,02K,all,02K_all_55,25919759,25920283,25920283,524
570,02K,all,02K_all_56,25954528,25954576,25954528,48
571,02K,all,02K_all_57,25955397,25961028,25960592,5631
572,02K,all,02K_all_58,25984100,25985005,25984490,905
573,02K,all,02K_all_59,26428125,26428301,26428125,176
574,02K,all,02K_all_60,26434994,26436342,26434994,1348
575,02K,all,02K_all_61,26441137,26448547,26441137,7410
576,02K,all,02K_all_62,26462178,26462588,26462178,410
577,02K,all,02K_all_63,26490743,26491623,26490743,880
578,02K,all,02K_all_64,26493139,26493862,26493668,723
579,02K,all,02K_all_65,26515471,26516125,26516006,654
580,02K,all,02K_all_66,26517066,26518942,26518614,1876
581,02K,all,02K_all_67,26523709,26523792,26523792,83
582,02K,all,02K_all_68,26553430,26553652,26553430,222
583,02K,all,02K_all_69,26563690,26564418,26563690,728
584,02K,all,02K_all_70,26845952,26847198,26845952,1246
585,02K,all,02K_all_71,26891094,26891986,26891094,892
586,02K,all,02K_all_72,26940480,26941088,26941088,608
587,02K,all,02K_all_73,26981693,26993794,26981693,12101
588,02K,all,02K_all_74,27013596,27013757,27013596,161
589,02K,all,02K_all_75,27024733,27025151,27025151,418
590,02K,all,02K_all_76,27028520,27029508,27028520,988
591,02K,all,02K_all_77,27040213,27040801,27040761,588
592,02K,all,02K_all_78,27041804,27042243,27042243,439
593,02K,all,02K_all_79,27045502,27045746,27045746,244
594,02K,all,02K_all_80,27047494,27047693,27047494,199
595,02K,all,02K_all_81,27054012,27054340,27054012,328
596,02K,all,02K_all_82,27093986,27094114,27094114,128
597,02K,all,02K_all_83,27097853,27099208,27097853,1355
598,02K,all,02K_all_84,27100887,27103304,27101016,2417
599,02K,all,02K_all_85,27260531,27261137,27260531,606
600,02K,all,02K_all_86,27277810,27279060,27278815,1250
601,02K,all,02K_all_87,27292016,27292252,27292016,236
602,02K,all,02K_all_88,27299245,27311074,27300557,11829
603,02K,all,02K_all_89,27343190,27345577,27344914,2387
604,02K,all,02K_all_90,27359783,27359815,27359815,32
605,02K,all,02K_all_91,27383878,27384889,27383938,1011
606,02K,all,02K_all_92,27387457,27387703,27387703,246
607,02K,all,02K_all_93,27412512,27413143,27412686,631
608,02K,all,02K_all_94,27419642,27420497,27420497,855
609,02K,all,02K_all_95,27449109,27449302,27449109,193
610,02K,all,02K_all_96,27450953,27451107,27450953,154
611,02K,all,02K_all_97,27560112,27560418,27560112,306
612,02K,all,02K_all_98,27577144,27577186,27577144,42
613,02K,all,02K_all_99,27605382,27605445,27605445,63
614,02K,all,02K_all_100,27614780,27614981,27614780,201
615,02K,all,02K_all_101,27622851,27623474,27623474,623
616,02K,all,02K_all_102,27632193,27632679,27632193,486
617,02K,all,02K_all_103,27649040,27649348,27649348,308
618,02K,all,02K_all_104,27654261,27655095,27654261,834
619,02K,all,02K_all_105,27657003,27657178,27657003,175
620,02K,all,02K_all_106,27657838,27658579,27658579,741
621,02K,all,02K_all_107,27761313,27762412,27762303,1099
622,02K,all,02K_all_108,27768543,27770438,27770438,1895
623,02K,all,02K_all_109,27771174,27771271,27771271,97
624,02K,all,02K_all_110,27777991,27778319,27777991,328
625,02K,all,02K_all_111,27845693,27845732,27845693,39
626,02K,all,02K_all_112,27855122,27855578,27855122,456
627,02K,all,02K_all_113,27857494,27858518,27857494,1024
628,02K,all,02K_all_114,27859823,27860372,27860372,549
629,02K,all,02K_all_115,27865276,27865581,27865581,305
630,02K,all,02K_all_116,27887650,27891444,27889427,3794
631,02K,all,02K_all_117,27905125,27905193,27905125,68
632,02K,all,02K_all_118,27907976,27909848,27908689,1872
633,02K,all,02K_all_119,27912097,27912302,27912097,205
634,02K,all,02K_all_120,27922478,27924348,27922561,1870
635,02K,all,02K_all_121,27931464,27931720,27931720,256
636,02K,all,02K_all_122,27936247,27941167,27941167,4920
637,02K,all,02K_all_123,27942772,27943202,27942772,430
638,02K,all,02K_all_124,27944876,27945839,27945251,963
639,02K,all,02K_all_125,27954119,27955063,27954119,944
640,02K,all,02K_all_126,27956080,27956206,27956206,126
641,02K,all,02K_all_127,28418771,28418810,28418771,39
642,02K,all,02K_all_128,30129448,30129919,30129648,471
643,02K,all,02K_all_129,30564846,30564915,30564846,69
644,02K,all,02K_all_130,31515767,31516041,31516041,274
645,02K,all,02K_all_131,31516927,31517328,31517328,401
646,02K,all,02K_all_132,31551485,31552175,31551485,690
647,02K,all,02K_all_133,31552629,31554466,31552810,1837
648,02K,all,02K_all_134,31559895,31560239,31559895,344
649,02K,all,02K_all_135,31561943,31563522,31563331,1579
650,02K,all,02K_all_136,31568766,31569828,31568766,1062
651,02K,all,02K_all_137,31571470,31572379,31572379,909
652,02K,all,02K_all_138,31581479,31581956,31581956,477
653,02K,all,02K_all_139,31589325,31590082,31590082,757
654,02K,all,02K_all_140,31593975,31594644,31594644,669
655,02K,all,02K_all_141,31625920,31627268,31627268,1348
656,02K,all,02K_all_142,31634494,31645661,31645661,11167
657,02K,all,02K_all_143,31660965,31660990,31660990,25
658,02K,all,02K_all_144,31682365,31683432,31682575,1067
659,02K,all,02K_all_145,31686111,31687403,31687402,1292
660,02K,all,02K_all_146,31693252,31694082,31694082,830
661,02K,all,02K_all_147,31699188,31699235,31699188,47
662,02K,all,02K_all_148,31855375,31855480,31855375,105
663,02K,all,02K_all_149,31857049,31857785,31857492,736
664,02K,all,02K_all_150,31871624,31872258,31871624,634
665,02K,all,02K_all_151,32498808,32499446,32498808,638
666,02K,all,02K_all_152,32505358,32510065,32509388,4707
667,02K,all,02K_all_153,32601844,32602235,32601844,391
668,02K,all,02K_all_154,32604551,32605111,32605111,560
669,02K,all,02K_all_155,32607733,32609201,32609201,1468
670,02K,all,02K_all_156,32611272,32611277,32611272,5
671,02K,all,02K_all_157,32616274,32617385,32616731,1111
672,02K,all,02K_all_158,32621511,32622248,32622145,737
673,02K,all,02K_all_159,32623435,32623914,32623435,479
674,02K,all,02K_all_160,32626681,32626851,32626851,170
675,02K,all,02K_all_161,32637111,32637153,32637111,42
676,02K,all,02K_all_162,32649579,32650456,32650456,877
677,02K,all,02K_all_163,32652101,32653391,32653391,1290
678,02K,all,02K_all_164,32671622,32672899,32671622,1277
679,02K,all,02K_all_165,32676899,32678891,32678865,1992
680,02K,all,02K_all_166,32682412,32683713,32682412,1301
681,02K,all,02K_all_167,33750194,33750242,33750194,48
682,02K,all,02K_all_168,34655558,34656019,34656019,461
683,02K,all,02K_all_169,35009187,35009328,35009187,141
684,02K,all,02K_all_170,35196025,35196247,35196025,222
685,02K,all,02K_all_171,35292487,35292761,35292761,274
686,02K,all,02K_all_172,35508200,35512505,35508200,4305
687,02K,all,02K_all_173,35527130,35527142,35527130,12
688,02K,all,02K_all_174,35532711,35533299,35532711,588
689,02K,all,02K_all_175,35541793,35542267,35542267,474
690,02K,all,02K_all_176,35545007,35545128,35545128,121
691,02K,all,02K_all_177,35903182,35906874,35906845,3692
692,02K,all,02K_all_178,36329459,36330021,36330021,562
693,02K,all,02K_all_179,36382917,36384288,36383738,1371
694,02K,all,02K_all_180,36484950,36485418,36485418,468
695,02K,all,02K_all_181,36493472,36495574,36495399,2102
696,02K,all,02K_all_182,36525967,36526633,36525967,666
697,02K,all,02K_all_183,36548904,36549263,36549263,359
698,02K,all,02K_all_184,36554096,36554356,36554173,260
699,02K,all,02K_all_185,36555047,36556505,36555969,1458
700,02K,all,02K_all_186,36558145,36558543,36558145,398
701,02K,all,02K_all_187,36559251,36560399,36559251,1148
702,02K,all,02K_all_188,36561609,36561610,36561610,1
703,02K,all,02K_all_189,36562085,36564045,36564045,1960
704,02K,all,02K_all_190,36569488,36574359,36569879,4871
705,02K,all,02K_all_191,36577535,36578150,36577535,615
706,02K,all,02K_all_192,36581070,36581651,36581651,581
707,02K,all,02K_all_193,36585692,36586103,36585837,411
708,02K,all,02K_all_194,36607436,36607537,36607537,101
709,02K,all,02K_all_195,36608854,36609712,36609712,858
710,02K,all,02K_all_196,36670236,36670430,36670430,194
711,02K,all,02K_all_197,42747442,42748257,42748257,815
712,02K,all,02K_all_198,43988059,43989992,43988059,1933
713,02K,all,02K_all_199,43993041,43994074,43994074,1033
714,02K,all,02K_all_200,44538616,44538742,44538616,126
715,02K,all,02K_all_201,44904925,44905313,44905313,388
716,02K,all,02K_all_202,46513063,46513689,46513236,626
717,02K,all,02K_all_203,46534196,46535121,46534196,925
718,02K,all,02K_all_204,48596694,48597718,48597718,1024
719,02K,all,02K_all_205,50367391,50367738,50367738,347
720,02K,all,02K_all_206,50435132,50438765,50435757,3633
721,02K,all,02K_all_207,51179678,51182183,51180173,2505
722,02K,all,02K_all_208,51192271,51193617,51192805,1346
723,02K,all,02K_all_209,53006014,53007043,53006014,1029
724,02K,all,02K_all_210,53364995,53373837,53367035,8842
725,02K,all,02K_all_211,53379967,53380894,53379967,927
726,02K,all,02K_all_212,53383162,53385280,53385280,2118
727,02K,all,02K_all_213,53459056,53461352,53459056,2296
728,02K,all,02K_all_214,53486659,53488089,53486659,1430
729,02K,all,02K_all_215,53504504,53508321,53508321,3817
730,02K,all,02K_all_216,53617185,53617679,53617297,494
731,02K,all,02K_all_217,53630782,53638650,53638650,7868
732,02K,all,02K_all_218,53965534,53976736,53974964,11202
733,02K,all,02K_all_219,53979075,53980128,53979075,1053
734,02K,all,02K_all_220,53981152,53981205,53981152,53
735,02K,all,02K_all_221,53984620,53988831,53984855,4211
736,02K,all,02K_all_222,53990470,53990795,53990470,325
737,02K,all,02K_all_223,53993569,53994367,53993569,798
738,02K,all,02K_all_224,54213859,54224248,54224248,10389
739,02K,all,02K_all_225,54647527,54647812,54647527,285
740,02K,all,02K_all_226,54675332,54685490,54680904,10158
741,02K,all,02K_all_227,54687694,54687732,54687694,38
742,02K,all,02K_all_228,54690362,54694436,54694304,4074
743,02K,all,02K_all_229,54699863,54700092,54699863,229
744,02K,all,02K_all_230,54706637,54710755,54709673,4118
745,02K,all,02K_all_231,54758027,54759575,54758027,1548
746,02K,all,02K_all_232,54896399,54897824,54896967,1425
747,02K,all,02K_all_233,57407227,57409818,57409445,2591
748,02K,all,02K_all_234,57433352,57436377,57436081,3025
749,02K,all,02K_all_235,58174832,58176394,58174832,1562
750,02K,all,02K_all_236,60443147,60443193,60443193,46
751,02K,all,02K_all_237,61923686,61925712,61924393,2026
752,02K,all,02K_all_238,61954463,61954973,61954482,510
753,02K,all,02K_all_239,62076844,62078602,62078602,1758
754,02K,all,02K_all_240,62082708,62083690,62083690,982
755,02K,all,02K_all_241,62085315,62087313,62087313,1998
756,02K,all,02K_all_242,62376931,62377128,62377128,197
757,02K,all,02K_all_243,62378608,62381348,62381348,2740
758,02K,all,02K_all_244,67797618,67798907,67797919,1289
759,02K,all,02K_all_245,68398723,68400018,68398856,1295
760,02N,all,02N_all_1,14805997,14806381,14806381,384
761,02N,all,02N_all_2,17390247,17390558,17390247,311
762,02N,all,02N_all_3,18884945,18885434,18885194,489
763,02N,all,02N_all_4,21498360,21507148,21498360,8788
764,02N,all,02N_all_5,22159538,22166544,22159538,7006
765,02N,all,02N_all_6,22176934,22184482,22176934,7548
766,02N,all,02N_all_7,22198078,22198238,22198238,160
767,02N,all,02N_all_8,22206076,22209601,22209161,3525
768,02N,all,02N_all_9,22222386,22222865,22222677,479
769,02N,all,02N_all_10,22325358,22326626,22325526,1268
770,02N,all,02N_all_11,22329463,22330247,22329463,784
771,02N,all,02N_all_12,22347903,22350868,22348805,2965
772,02N,all,02N_all_13,22370552,22371767,22370552,1215
773,02N,all,02N_all_14,22425886,22427273,22426835,1387
774,02N,all,02N_all_15,22442369,22444256,22443655,1887
775,02N,all,02N_all_16,22447797,22448014,22447797,217
776,02N,all,02N_all_17,22451318,22454193,22451318,2875
777,02N,all,02N_all_18,22455278,22455366,22455366,88
778,02N,all,02N_all_19,22477782,22479281,22478677,1499
779,02N,all,02N_all_20,22501485,22505272,22504132,3787
780,02N,all,02N_all_21,22508548,22508985,22508985,437
781,02N,all,02N_all_22,22513289,22513548,22513289,259
782,02N,all,02N_all_23,22514252,22515627,22515077,1375
783,02N,all,02N_all_24,22517035,22517313,22517035,278
784,02N,all,02N_all_25,22533249,22534435,22533405,1186
785,02N,all,02N_all_26,22545842,22550801,22550801,4959
786,02N,all,02N_all_27,22552197,22567083,22553212,14886
787,02N,all,02N_all_28,22568925,22569179,22568925,254
788,02N,all,02N_all_29,22618342,22618945,22618513,603
789,02N,all,02N_all_30,22636419,22636500,22636500,81
790,02N,all,02N_all_31,22638295,22639269,22638459,974
791,02N,all,02N_all_32,22678545,22679439,22678545,894
792,02N,all,02N_all_33,22701573,22704924,22703245,3351
793,02N,all,02N_all_34,22739567,22741962,22740275,2395
794,02N,all,02N_all_35,22744201,22745051,22744999,850
795,02N,all,02N_all_36,22763414,22764258,22764258,844
796,02N,all,02N_all_37,22769782,22769817,22769817,35
797,02N,all,02N_all_38,22781223,22782073,22781718,850
798,02N,all,02N_all_39,22783576,22784668,22784399,1092
799,02N,all,02N_all_40,22786134,22786730,22786730,596
800,02N,all,02N_all_41,22810338,22812866,22812029,2528
801,02N,all,02N_all_42,22828068,22828959,22828959,891
802,02N,all,02N_all_43,22831172,22832371,22831172,1199
803,02N,all,02N_all_44,22850609,22851538,22851538,929
804,02N,all,02N_all_45,22852575,22853277,22853277,702
805,02N,all,02N_all_46,22857367,22858770,22858770,1403
806,02N,all,02N_all_47,22901583,22908837,22901687,7254
807,02N,all,02N_all_48,22937460,22940531,22937460,3071
808,02N,all,02N_all_49,22949896,22952783,22949896,2887
809,02N,all,02N_all_50,22956044,22957534,22957534,1490
810,02N,all,02N_all_51,22959719,22960968,22959719,1249
811,02N,all,02N_all_52,22962651,22963172,22962651,521
812,02N,all,02N_all_53,22965061,22967554,22965357,2493
813,02N,all,02N_all_54,24269051,24270334,24269571,1283
814,02N,all,02N_all_55,24295717,24295796,24295717,79
815,02N,all,02N_all_56,24300247,24303858,24300692,3611
816,02N,all,02N_all_57,24308369,24308463,24308463,94
817,02N,all,02N_all_58,24313129,24313397,24313129,268
818,02N,all,02N_all_59,24315329,24321804,24315512,6475
819,02N,all,02N_all_60,24322531,24330392,24329602,7861
820,02N,all,02N_all_61,24331219,24335251,24331257,4032
821,02N,all,02N_all_62,24337329,24338059,24338059,730
822,02N,all,02N_all_63,24355616,24367694,24366232,12078
823,02N,all,02N_all_64,24385507,24387625,24387177,2118
824,02N,all,02N_all_65,24397838,24397875,24397875,37
825,02N,all,02N_all_66,24414228,24415346,24414228,1118
826,02N,all,02N_all_67,24421972,24426289,24425353,4317
827,02N,all,02N_all_68,24468506,24469008,24469008,502
828,02N,all,02N_all_69,24501211,24506548,24501211,5337
829,02N,all,02N_all_70,24509655,24529194,24510541,19539
830,02N,all,02N_all_71,24532252,24535699,24532252,3447
831,02N,all,02N_all_72,24798790,24799166,24799166,376
832,02N,all,02N_all_73,24801185,24804389,24803560,3204
833,02N,all,02N_all_74,24811783,24812676,24811783,893
834,02N,all,02N_all_75,24827796,24829551,24827796,1755
835,02N,all,02N_all_76,24838184,24841466,24838184,3282
836,02N,all,02N_all_77,24847644,24847742,24847742,98
837,02N,all,02N_all_78,24852207,24855926,24855926,3719
838,02N,all,02N_all_79,24857853,24860604,24858521,2751
839,02N,all,02N_all_80,24886920,24887894,24887894,974
840,02N,all,02N_all_81,24905645,24907143,24906950,1498
841,02N,all,02N_all_82,24919341,24919539,24919341,198
842,02N,all,02N_all_83,24928908,24929198,24929198,290
843,02N,all,02N_all_84,24930695,24930717,24930717,22
844,02N,all,02N_all_85,24965654,24965979,24965979,325
845,02N,all,02N_all_86,24972235,24972455,24972455,220
846,02N,all,02N_all_87,24995561,24995948,24995948,387
847,02N,all,02N_all_88,25001566,25010098,25009711,8532
848,02N,all,02N_all_89,25011564,25012885,25012568,1321
849,02N,all,02N_all_90,25014709,25014926,25014926,217
850,02N,all,02N_all_91,25047010,25047791,25047010,781
851,02N,all,02N_all_92,25051635,25051696,25051635,61
852,02N,all,02N_all_93,25063996,25068908,25068908,4912
853,02N,all,02N_all_94,25069868,25071690,25071690,1822
854,02N,all,02N_all_95,25351685,25379267,25372729,27582
855,02N,all,02N_all_96,25454866,25455314,25454975,448
856,02N,all,02N_all_97,25486901,25487265,25487184,364
857,02N,all,02N_all_98,25523920,25525207,25523920,1287
858,02N,all,02N_all_99,25535821,25537624,25537624,1803
859,02N,all,02N_all_100,25548203,25548412,25548203,209
860,02N,all,02N_all_101,25556109,25561661,25556819,5552
861,02N,all,02N_all_102,25563753,25564359,25564359,606
862,02N,all,02N_all_103,25566751,25577338,25575204,10587
863,02N,all,02N_all_104,25777017,25781598,25777017,4581
864,02N,all,02N_all_105,26051256,26052177,26051256,921
865,02N,all,02N_all_106,26056342,26058637,26056342,2295
866,02N,all,02N_all_107,27353101,27358836,27354893,5735
867,02N,all,02N_all_108,27360570,27361009,27360570,439
868,02N,all,02N_all_109,27603240,27605861,27605839,2621
869,02N,all,02N_all_110,27699848,27701729,27700588,1881
870,02N,all,02N_all_111,27704893,27705667,27705092,774
871,02N,all,02N_all_112,27709048,27711264,27711264,2216
872,02N,all,02N_all_113,27715566,27715639,27715566,73
873,02N,all,02N_all_114,27718240,27719813,27719813,1573
874,02N,all,02N_all_115,27727263,27728083,27727272,820
875,02N,all,02N_all_116,27734040,27735039,27735039,999
876,02N,all,02N_all_117,27737987,27738911,27738160,924
877,02N,all,02N_all_118,27748493,27752034,27752034,3541
878,02N,all,02N_all_119,27759992,27760709,27760049,717
879,02N,all,02N_all_120,27768856,27769238,27768856,382
880,02N,all,02N_all_121,27774088,27775525,27775525,1437
881,02N,all,02N_all_122,27783776,27794678,27794488,10902
882,02N,all,02N_all_123,27796806,27797933,27797933,1127
883,02N,all,02N_all_124,27799706,27802146,27802146,2440
884,02N,all,02N_all_125,27804467,27805566,27804467,1099
885,02N,all,02N_all_126,27808048,27809941,27808209,1893
886,02N,all,02N_all_127,27822752,27824543,27822752,1791
887,02N,all,02N_all_128,27849604,27850130,27850130,526
888,02N,all,02N_all_129,27854302,27856658,27855417,2356
889,02N,all,02N_all_130,27861858,27864946,27864946,3088
890,02N,all,02N_all_131,27912851,27919081,27917045,6230
891,02N,all,02N_all_132,27925855,27927509,27926809,1654
892,02N,all,02N_all_133,27931305,27934081,27934081,2776
893,02N,all,02N_all_134,27939080,27939323,27939080,243
894,02N,all,02N_all_135,27949541,27951683,27949541,2142
895,02N,all,02N_all_136,27966475,27966881,27966475,406
896,02N,all,02N_all_137,27971568,27971630,27971630,62
897,02N,all,02N_all_138,27976231,27976783,27976783,552
898,02N,all,02N_all_139,27979023,27980057,27980057,1034
899,02N,all,02N_all_140,27982471,27983342,27983342,871
900,02N,all,02N_all_141,27985958,27986972,27986972,1014
901,02N,all,02N_all_142,28063902,28064608,28064318,706
902,02N,all,02N_all_143,28066140,28066902,28066902,762
903,02N,all,02N_all_144,28069886,28070047,28069886,161
904,02N,all,02N_all_145,28071442,28072514,28072347,1072
905,02N,all,02N_all_146,28081547,28081627,28081627,80
906,02N,all,02N_all_147,28089828,28089973,28089973,145
907,02N,all,02N_all_148,28098506,28099764,28099764,1258
908,02N,all,02N_all_149,28107820,28107837,28107837,17
909,02N,all,02N_all_150,28108585,28118787,28118492,10202
910,02N,all,02N_all_151,28120012,28160154,28120012,40142
911,02N,all,02N_all_152,28282286,28283906,28282286,1620
912,02N,all,02N_all_153,28289256,28290409,28289612,1153
913,02N,all,02N_all_154,28295557,28295819,28295819,262
914,02N,all,02N_all_155,28297521,28304501,28304501,6980
915,02N,all,02N_all_156,28341999,28343454,28342738,1455
916,02N,all,02N_all_157,28344508,28345952,28345585,1444
917,02N,all,02N_all_158,28348283,28349920,28349920,1637
918,02N,all,02N_all_159,28357047,28359929,28359720,2882
919,02N,all,02N_all_160,28363897,28366655,28365794,2758
920,02N,all,02N_all_161,28381692,28384995,28384197,3303
921,02N,all,02N_all_162,28389342,28390633,28389342,1291
922,02N,all,02N_all_163,28461517,28461901,28461832,384
923,02N,all,02N_all_164,28470005,28473061,28472500,3056
924,02N,all,02N_all_165,28478999,28480905,28480905,1906
925,02N,all,02N_all_166,28482767,28483756,28483756,989
926,02N,all,02N_all_167,28486347,28486564,28486347,217
927,02N,all,02N_all_168,28494587,28496151,28496151,1564
928,02N,all,02N_all_169,28497934,28497982,28497982,48
929,02N,all,02N_all_170,28520069,28522918,28522918,2849
930,02N,all,02N_all_171,28529705,28532255,28532255,2550
931,02N,all,02N_all_172,28533976,28534237,28533976,261
932,02N,all,02N_all_173,28558111,28561408,28561408,3297
933,02N,all,02N_all_174,28565349,28565494,28565349,145
934,02N,all,02N_all_175,28566720,28570215,28570215,3495
935,02N,all,02N_all_176,28589357,28591185,28591185,1828
936,02N,all,02N_all_177,28596640,28597964,28596640,1324
937,02N,all,02N_all_178,28601803,28605213,28604024,3410
938,02N,all,02N_all_179,28615062,28616410,28615062,1348
939,02N,all,02N_all_180,28621739,28623418,28621852,1679
940,02N,all,02N_all_181,28627536,28628718,28627536,1182
941,02N,all,02N_all_182,28631798,28634847,28631798,3049
942,02N,all,02N_all_183,28642673,28643001,28642704,328
943,02N,all,02N_all_184,28648932,28651262,28648932,2330
944,02N,all,02N_all_185,28670480,28670734,28670480,254
945,02N,all,02N_all_186,28673599,28694443,28694443,20844
946,02N,all,02N_all_187,28718583,28718823,28718823,240
947,02N,all,02N_all_188,28722022,28722647,28722647,625
948,02N,all,02N_all_189,28731686,28735534,28731686,3848
949,02N,all,02N_all_190,28771214,28793054,28774816,21840
950,02N,all,02N_all_191,28799441,28799775,28799775,334
951,02N,all,02N_all_192,28814738,28814999,28814999,261
952,02N,all,02N_all_193,28817468,28818167,28817468,699
953,02N,all,02N_all_194,28819807,28820917,28820917,1110
954,02N,all,02N_all_195,28839510,28841800,28839510,2290
955,02N,all,02N_all_196,28848076,28848129,28848129,53
956,02N,all,02N_all_197,28891062,28893127,28893127,2065
957,02N,all,02N_all_198,28902498,28907588,28902498,5090
958,02N,all,02N_all_199,28915099,28917482,28917001,2383
959,02N,all,02N_all_200,28919315,28926009,28919315,6694
960,02N,all,02N_all_201,28927281,28932618,28932508,5337
961,02N,all,02N_all_202,28935479,28937837,28935479,2358
962,02N,all,02N_all_203,28941888,28943057,28943057,1169
963,02N,all,02N_all_204,28948310,28949461,28948310,1151
964,02N,all,02N_all_205,28965629,28967602,28967119,1973
965,02N,all,02N_all_206,28970428,28973950,28970428,3522
966,02N,all,02N_all_207,28981227,28986917,28981968,5690
967,02N,all,02N_all_208,28990147,28990243,28990147,96
968,02N,all,02N_all_209,28995331,28997672,28997672,2341
969,02N,all,02N_all_210,29004590,29008485,29008473,3895
970,02N,all,02N_all_211,29011071,29011638,29011071,567
971,02N,all,02N_all_212,29013170,29014970,29014970,1800
972,02N,all,02N_all_213,29039923,29040779,29039923,856
973,02N,all,02N_all_214,29048802,29049308,29049308,506
974,02N,all,02N_all_215,29050498,29052657,29052657,2159
975,02N,all,02N_all_216,29053942,29057027,29057027,3085
976,02N,all,02N_all_217,29063622,29065475,29063622,1853
977,02N,all,02N_all_218,29073715,29075854,29074690,2139
978,02N,all,02N_all_219,29077038,29077628,29077628,590
979,02N,all,02N_all_220,29080073,29081686,29080073,1613
980,02N,all,02N_all_221,29085673,29086142,29085673,469
981,02N,all,02N_all_222,29088704,29090488,29088704,1784
982,02N,all,02N_all_223,29134754,29135401,29134757,647
983,02N,all,02N_all_224,29139552,29139708,29139552,156
984,02N,all,02N_all_225,29165616,29169484,29169484,3868
985,02N,all,02N_all_226,29178978,29180110,29178978,1132
986,02N,all,02N_all_227,29182118,29182415,29182118,297
987,02N,all,02N_all_228,29187037,29187046,29187037,9
988,02N,all,02N_all_229,29193257,29193806,29193257,549
989,02N,all,02N_all_230,29199641,29200837,29200837,1196
990,02N,all,02N_all_231,29208838,29209150,29209150,312
991,02N,all,02N_all_232,29211399,29215669,29215669,4270
992,02N,all,02N_all_233,29217941,29219519,29218514,1578
993,02N,all,02N_all_234,29228507,29236623,29228507,8116
994,02N,all,02N_all_235,29239533,29240612,29239533,1079
995,02N,all,02N_all_236,29244197,29249856,29249856,5659
996,02N,all,02N_all_237,29254752,29257932,29255373,3180
997,02N,all,02N_all_238,29262570,29263144,29262570,574
998,02N,all,02N_all_239,29273567,29278602,29273567,5035
999,02N,all,02N_all_240,29280630,29280722,29280722,92
1000,02N,all,02N_all_241,29291104,29294792,29294792,3688
1001,02N,all,02N_all_242,29296510,29296532,29296510,22
1002,02N,all,02N_all_243,29320304,29322470,29320304,2166
1003,02N,all,02N_all_244,29325469,29325992,29325992,523
1004,02N,all,02N_all_245,29328712,29330149,29329383,1437
1005,02N,all,02N_all_246,29332772,29333441,29333441,669
1006,02N,all,02N_all_247,29334812,29338093,29337589,3281
1007,02N,all,02N_all_248,29354758,29355444,29355257,686
1008,02N,all,02N_all_249,29358113,29359068,29358994,955
1009,02N,all,02N_all_250,29366371,29366951,29366951,580
1010,02N,all,02N_all_251,29370135,29371103,29370135,968
1011,02N,all,02N_all_252,29377096,29378217,29378217,1121
1012,02N,all,02N_all_253,29384726,29385743,29385308,1017
1013,02N,all,02N_all_254,29399479,29405770,29399479,6291
1014,02N,all,02N_all_255,29408042,29409991,29408042,1949
1015,02N,all,02N_all_256,29411564,29413427,29411739,1863
1016,02N,all,02N_all_257,29415301,29415995,29415301,694
1017,02N,all,02N_all_258,29421090,29421405,29421090,315
1018,02N,all,02N_all_259,29428187,29428798,29428187,611
1019,02N,all,02N_all_260,29435106,29440777,29440092,5671
1020,02N,all,02N_all_261,29455787,29457026,29455787,1239
1021,02N,all,02N_all_262,29480894,29484964,29480894,4070
1022,02N,all,02N_all_263,29486635,29487434,29486635,799
1023,02N,all,02N_all_264,29523092,29524672,29523668,1580
1024,02N,all,02N_all_265,29526853,29527087,29526853,234
1025,02N,all,02N_all_266,29528629,29528663,29528663,34
1026,02N,all,02N_all_267,29558252,29558516,29558516,264
1027,02N,all,02N_all_268,29671164,29672449,29671164,1285
1028,02N,all,02N_all_269,29681943,29683137,29683137,1194
1029,02N,all,02N_all_270,29688180,29688451,29688180,271
1030,02N,all,02N_all_271,29696045,29697246,29697246,1201
1031,02N,all,02N_all_272,29697951,29698764,29698764,813
1032,02N,all,02N_all_273,29700338,29702405,29700769,2067
1033,02N,all,02N_all_274,29722753,29722804,29722804,51
1034,02N,all,02N_all_275,29732706,29737435,29733189,4729
1035,02N,all,02N_all_276,29749485,29750365,29750365,880
1036,02N,all,02N_all_277,29760260,29760605,29760260,345
1037,02N,all,02N_all_278,29762278,29765150,29762789,2872
1038,02N,all,02N_all_279,29792360,29794024,29792360,1664
1039,02N,all,02N_all_280,29805533,29806874,29805533,1341
1040,02N,all,02N_all_281,29807963,29808060,29808060,97
1041,02N,all,02N_all_282,29812039,29812083,29812083,44
1042,02N,all,02N_all_283,29814164,29814231,29814231,67
1043,02N,all,02N_all_284,29822223,29823370,29822223,1147
1044,02N,all,02N_all_285,29831396,29831446,29831446,50
1045,02N,all,02N_all_286,29832413,29834128,29834128,1715
1046,02N,all,02N_all_287,29837529,29847390,29847390,9861
1047,02N,all,02N_all_288,29867935,29868418,29868418,483
1048,02N,all,02N_all_289,29870236,29870376,29870376,140
1049,02N,all,02N_all_290,29885896,29886580,29886580,684
1050,02N,all,02N_all_291,29929731,29941019,29941019,11288
1051,02N,all,02N_all_292,29942143,29942239,29942143,96
1052,02N,all,02N_all_293,29949346,29950421,29949768,1075
1053,02N,all,02N_all_294,29957584,29958868,29958868,1284
1054,02N,all,02N_all_295,29983499,29987007,29986272,3508
1055,02N,all,02N_all_296,29999610,30000612,30000001,1002
1056,02N,all,02N_all_297,30002506,30004079,30002957,1573
1057,02N,all,02N_all_298,30074369,30076524,30075362,2155
1058,02N,all,02N_all_299,30077150,30078760,30077188,1610
1059,02N,all,02N_all_300,30082594,30084608,30083738,2014
1060,02N,all,02N_all_301,30111382,30111990,30111382,608
1061,02N,all,02N_all_302,30113903,30113931,30113903,28
1062,02N,all,02N_all_303,30200220,30200683,30200683,463
1063,02N,all,02N_all_304,30325980,30326274,30326274,294
1064,02N,all,02N_all_305,30518398,30518508,30518508,110
1065,02N,all,02N_all_306,30544646,30544871,30544871,225
1066,02N,all,02N_all_307,30548401,30553625,30550822,5224
1067,02N,all,02N_all_308,30555715,30555851,30555773,136
1068,02N,all,02N_all_309,30559326,30569516,30568083,10190
1069,02N,all,02N_all_310,30583853,30584310,30584310,457
1070,02N,all,02N_all_311,30634397,30637633,30635739,3236
1071,02N,all,02N_all_312,30645396,30653717,30653717,8321
1072,02N,all,02N_all_313,30657232,30661659,30661659,4427
1073,02N,all,02N_all_314,30675280,30676093,30675280,813
1074,02N,all,02N_all_315,30679463,30680119,30679463,656
1075,02N,all,02N_all_316,30684255,30684749,30684255,494
1076,02N,all,02N_all_317,30689588,30690430,30689588,842
1077,02N,all,02N_all_318,30696253,30696538,30696458,285
1078,02N,all,02N_all_319,30698052,30698390,30698390,338
1079,02N,all,02N_all_320,30709235,30711929,30711929,2694
1080,02N,all,02N_all_321,30720995,30721532,30720995,537
1081,02N,all,02N_all_322,30729474,30731885,30730004,2411
1082,02N,all,02N_all_323,30736417,30738413,30736417,1996
1083,02N,all,02N_all_324,30760263,30761392,30760263,1129
1084,02N,all,02N_all_325,30766874,30768720,30767485,1846
1085,02N,all,02N_all_326,30769895,30770181,30769895,286
1086,02N,all,02N_all_327,30800103,30800485,30800485,382
1087,02N,all,02N_all_328,30962984,30964203,30964203,1219
1088,02N,all,02N_all_329,30967998,30969245,30969186,1247
1089,02N,all,02N_all_330,30972231,30973526,30973491,1295
1090,02N,all,02N_all_331,30984479,30985549,30984479,1070
1091,02N,all,02N_all_332,30987131,30987326,30987326,195
1092,02N,all,02N_all_333,30989873,30990372,30989873,499
1093,02N,all,02N_all_334,30993752,30994158,30993941,406
1094,02N,all,02N_all_335,30996363,30998800,30996363,2437
1095,02N,all,02N_all_336,31002329,31003707,31003707,1378
1096,02N,all,02N_all_337,31004917,31004996,31004996,79
1097,02N,all,02N_all_338,31035582,31038970,31036015,3388
1098,02N,all,02N_all_339,31041162,31041328,31041328,166
1099,02N,all,02N_all_340,31042489,31044417,31042790,1928
1100,02N,all,02N_all_341,31046475,31046567,31046567,92
1101,02N,all,02N_all_342,31079072,31079950,31079950,878
1102,02N,all,02N_all_343,31089793,31092963,31092347,3170
1103,02N,all,02N_all_344,31110854,31112051,31112051,1197
1104,02N,all,02N_all_345,31119021,31120005,31120005,984
1105,02N,all,02N_all_346,31121799,31124545,31121799,2746
1106,02N,all,02N_all_347,31125683,31126137,31125683,454
1107,02N,all,02N_all_348,31128659,31131162,31128659,2503
1108,02N,all,02N_all_349,31132378,31133209,31132378,831
1109,02N,all,02N_all_350,31135960,31136893,31135960,933
1110,02N,all,02N_all_351,31156357,31157319,31156357,962
1111,02N,all,02N_all_352,31158622,31161929,31158642,3307
1112,02N,all,02N_all_353,31200188,31200912,31200188,724
1113,02N,all,02N_all_354,31207445,31221403,31207984,13958
1114,02N,all,02N_all_355,31255772,31258078,31258078,2306
1115,02N,all,02N_all_356,31264523,31264809,31264523,286
1116,02N,all,02N_all_357,31281558,31291993,31291993,10435
1117,02N,all,02N_all_358,31294708,31295451,31294708,743
1118,02N,all,02N_all_359,31319608,31322120,31322120,2512
1119,02N,all,02N_all_360,31330407,31330765,31330765,358
1120,02N,all,02N_all_361,31343902,31345575,31343902,1673
1121,02N,all,02N_all_362,31362710,31363501,31362743,791
1122,02N,all,02N_all_363,31368467,31368468,31368468,1
1123,02N,all,02N_all_364,31901814,31905287,31901814,3473
1124,02N,all,02N_all_365,31906792,31907507,31907507,715
1125,02N,all,02N_all_366,31974587,31979595,31975849,5008
1126,02N,all,02N_all_367,31980589,31982936,31982785,2347
1127,02N,all,02N_all_368,31984077,31984090,31984090,13
1128,02N,all,02N_all_369,32057135,32057679,32057679,544
1129,02N,all,02N_all_370,32063630,32063927,32063630,297
1130,02N,all,02N_all_371,32064716,32070227,32064716,5511
1131,02N,all,02N_all_372,32139606,32143085,32141023,3479
1132,02N,all,02N_all_373,32145929,32146593,32146593,664
1133,02N,all,02N_all_374,32175970,32177433,32175970,1463
1134,02N,all,02N_all_375,32178912,32179656,32179656,744
1135,02N,all,02N_all_376,32180739,32183333,32180739,2594
1136,02N,all,02N_all_377,32196031,32197171,32197171,1140
1137,02N,all,02N_all_378,32200703,32201300,32201300,597
1138,02N,all,02N_all_379,32202242,32202467,32202467,225
1139,02N,all,02N_all_380,32203992,32204658,32204658,666
1140,02N,all,02N_all_381,32206553,32207454,32206553,901
1141,02N,all,02N_all_382,32208344,32210264,32209194,1920
1142,02N,all,02N_all_383,32212481,32212655,32212655,174
1143,02N,all,02N_all_384,32231883,32232581,32232581,698
1144,02N,all,02N_all_385,32249569,32249710,32249569,141
1145,02N,all,02N_all_386,32250871,32251246,32251246,375
1146,02N,all,02N_all_387,32252090,32252302,32252302,212
1147,02N,all,02N_all_388,32255741,32256689,32255741,948
1148,02N,all,02N_all_389,32265119,32265636,32265636,517
1149,02N,all,02N_all_390,32268260,32269209,32268600,949
1150,02N,all,02N_all_391,32270261,32271438,32270261,1177
1151,02N,all,02N_all_392,32276219,32276307,32276307,88
1152,02N,all,02N_all_393,32281784,32283094,32283094,1310
1153,02N,all,02N_all_394,32292664,32295187,32292664,2523
1154,02N,all,02N_all_395,32316547,32319390,32319390,2843
1155,02N,all,02N_all_396,32341949,32342756,32341949,807
1156,02N,all,02N_all_397,32348154,32350994,32348758,2840
1157,02N,all,02N_all_398,32353668,32353731,32353731,63
1158,02N,all,02N_all_399,32359531,32359600,32359600,69
1159,02N,all,02N_all_400,32362128,32363012,32362824,884
1160,02N,all,02N_all_401,32367114,32368187,32368187,1073
1161,02N,all,02N_all_402,32375551,32378355,32378355,2804
1162,02N,all,02N_all_403,32380778,32381801,32380825,1023
1163,02N,all,02N_all_404,32439382,32442892,32439382,3510
1164,02N,all,02N_all_405,32456063,32458319,32456063,2256
1165,02N,all,02N_all_406,32462619,32466679,32465315,4060
1166,02N,all,02N_all_407,32492335,32495406,32494088,3071
1167,02N,all,02N_all_408,32496517,32496887,32496887,370
1168,02N,all,02N_all_409,32499077,32499142,32499142,65
1169,02N,all,02N_all_410,32505353,32505652,32505353,299
1170,02N,all,02N_all_411,32507381,32507979,32507381,598
1171,02N,all,02N_all_412,32515170,32515205,32515170,35
1172,02N,all,02N_all_413,32517783,32518378,32518378,595
1173,02N,all,02N_all_414,32522722,32523939,32522722,1217
1174,02N,all,02N_all_415,32529968,32530202,32529968,234
1175,02N,all,02N_all_416,32551670,32551879,32551879,209
1176,02N,all,02N_all_417,32554869,32555613,32555613,744
1177,02N,all,02N_all_418,32559452,32561020,32559452,1568
1178,02N,all,02N_all_419,32562414,32567467,32566829,5053
1179,02N,all,02N_all_420,32569171,32571114,32569311,1943
1180,02N,all,02N_all_421,32572998,32573038,32572998,40
1181,02N,all,02N_all_422,32575011,32576277,32575322,1266
1182,02N,all,02N_all_423,32580490,32582301,32582301,1811
1183,02N,all,02N_all_424,32586929,32590258,32586929,3329
1184,02N,all,02N_all_425,32592149,32592428,32592428,279
1185,02N,all,02N_all_426,32598457,32598744,32598457,287
1186,02N,all,02N_all_427,32612313,32614540,32614286,2227
1187,02N,all,02N_all_428,32615928,32616903,32616903,975
1188,02N,all,02N_all_429,32627941,32628248,32627941,307
1189,02N,all,02N_all_430,32631162,32633480,32631162,2318
1190,02N,all,02N_all_431,32672551,32673005,32672551,454
1191,02N,all,02N_all_432,32680805,32682939,32682939,2134
1192,02N,all,02N_all_433,32685507,32685824,32685824,317
1193,02N,all,02N_all_434,32688499,32688723,32688499,224
1194,02N,all,02N_all_435,32701911,32704176,32704176,2265
1195,02N,all,02N_all_436,32706481,32709021,32706481,2540
1196,02N,all,02N_all_437,32710630,32712945,32712003,2315
1197,02N,all,02N_all_438,32715377,32717173,32717173,1796
1198,02N,all,02N_all_439,32718236,32718301,32718236,65
1199,02N,all,02N_all_440,32727081,32727753,32727081,672
1200,02N,all,02N_all_441,32730826,32732535,32732057,1709
1201,02N,all,02N_all_442,32737044,32741555,32737455,4511
1202,02N,all,02N_all_443,32745365,32745974,32745365,609
1203,02N,all,02N_all_444,32750382,32750552,32750382,170
1204,02N,all,02N_all_445,32756857,32758568,32758167,1711
1205,02N,all,02N_all_446,32761102,32761370,32761370,268
1206,02N,all,02N_all_447,32763065,32763690,32763065,625
1207,02N,all,02N_all_448,32797783,32798181,32798181,398
1208,02N,all,02N_all_449,32800680,32801871,32801108,1191
1209,02N,all,02N_all_450,32824367,32827347,32824367,2980
1210,02N,all,02N_all_451,32838386,32838639,32838639,253
1211,02N,all,02N_all_452,32859172,32859807,32859172,635
1212,02N,all,02N_all_453,32884805,32886629,32884805,1824
1213,02N,all,02N_all_454,32891944,32892045,32892044,101
1214,02N,all,02N_all_455,32893029,32893227,32893206,198
1215,02N,all,02N_all_456,32898633,32900062,32899832,1429
1216,02N,all,02N_all_457,32900539,32900883,32900539,344
1217,02N,all,02N_all_458,32901569,32901785,32901785,216
1218,02N,all,02N_all_459,32908573,32911658,32910869,3085
1219,02N,all,02N_all_460,32925948,32927107,32926319,1159
1220,02N,all,02N_all_461,32931385,32932267,32932267,882
1221,02N,all,02N_all_462,32942435,32943241,32942555,806
1222,02N,all,02N_all_463,32944194,32944709,32944194,515
1223,02N,all,02N_all_464,32946455,32948907,32946505,2452
1224,02N,all,02N_all_465,32956823,32957874,32956823,1051
1225,02N,all,02N_all_466,32961854,32962936,32962936,1082
1226,02N,all,02N_all_467,32965384,32966389,32965384,1005
1227,02N,all,02N_all_468,32967903,32971039,32970186,3136
1228,02N,all,02N_all_469,32972510,32972872,32972510,362
1229,02N,all,02N_all_470,32976341,32977337,32976801,996
1230,02N,all,02N_all_471,32980329,32981707,32980329,1378
1231,02N,all,02N_all_472,32987071,33000659,33000524,13588
1232,02N,all,02N_all_473,33004501,33004984,33004501,483
1233,02N,all,02N_all_474,33009536,33013626,33013626,4090
1234,02N,all,02N_all_475,33015136,33016187,33015679,1051
1235,02N,all,02N_all_476,33020633,33021807,33021807,1174
1236,02N,all,02N_all_477,33025235,33025556,33025556,321
1237,02N,all,02N_all_478,33027562,33028220,33028220,658
1238,02N,all,02N_all_479,33031743,33033077,33031743,1334
1239,02N,all,02N_all_480,33048263,33050469,33050469,2206
1240,02N,all,02N_all_481,33114808,33131550,33115286,16742
1241,02N,all,02N_all_482,33138995,33139137,33138995,142
1242,02N,all,02N_all_483,33150943,33151165,33151165,222
1243,02N,all,02N_all_484,33153323,33155163,33155163,1840
1244,02N,all,02N_all_485,33156001,33156561,33156109,560
1245,02N,all,02N_all_486,33159243,33159612,33159243,369
1246,02N,all,02N_all_487,33167424,33167765,33167424,341
1247,02N,all,02N_all_488,33311852,33312190,33312190,338
1248,02N,all,02N_all_489,33325497,33331800,33325497,6303
1249,02N,all,02N_all_490,33333931,33334773,33334044,842
1250,02N,all,02N_all_491,33340435,33341111,33340435,676
1251,02N,all,02N_all_492,33372952,33374753,33374128,1801
1252,02N,all,02N_all_493,33378097,33380420,33378097,2323
1253,02N,all,02N_all_494,33383289,33384799,33383289,1510
1254,02N,all,02N_all_495,33387873,33388653,33387873,780
1255,02N,all,02N_all_496,33410416,33411527,33411527,1111
1256,02N,all,02N_all_497,33432259,33433992,33433892,1733
1257,02N,all,02N_all_498,33440080,33440553,33440080,473
1258,02N,all,02N_all_499,33470160,33470943,33470943,783
1259,02N,all,02N_all_500,43744259,43744617,43744617,358
1260,02N,all,02N_all_501,43748667,43750349,43748667,1682
1261,02N,all,02N_all_502,43978779,43981386,43981386,2607
1262,02N,all,02N_all_503,44159285,44159773,44159285,488
1263,02N,all,02N_all_504,45385878,45385879,45385878,1
1264,02N,all,02N_all_505,45556302,45557519,45556302,1217
1265,02N,all,02N_all_506,45563316,45566427,45563916,3111
1266,02N,all,02N_all_507,45574378,45576635,45574378,2257
1267,02N,all,02N_all_508,46116266,46116703,46116266,437
1268,02N,all,02N_all_509,46148609,46153181,46152646,4572
1269,02N,all,02N_all_510,46165633,46166918,46166274,1285
1270,02N,all,02N_all_511,46169153,46169549,46169153,396
1271,02N,all,02N_all_512,46173271,46174871,46173271,1600
1272,02N,all,02N_all_513,46177209,46192335,46178959,15126
1273,02N,all,02N_all_514,46207252,46208043,46208043,791
1274,02N,all,02N_all_515,46209471,46212894,46212894,3423
1275,02N,all,02N_all_516,46214087,46215330,46215330,1243
1276,02N,all,02N_all_517,46216504,46217683,46216677,1179
1277,02N,all,02N_all_518,46219538,46219858,46219718,320
1278,02N,all,02N_all_519,46221740,46223801,46221740,2061
1279,02N,all,02N_all_520,46225092,46225664,46225664,572
1280,02N,all,02N_all_521,46227794,46228969,46228297,1175
1281,02N,all,02N_all_522,46229674,46230389,46229674,715
1282,02N,all,02N_all_523,46263301,46264757,46264757,1456
1283,02N,all,02N_all_524,47724853,47724891,47724891,38
1284,02N,all,02N_all_525,47726481,47726491,47726481,10
1285,02N,all,02N_all_526,49561205,49563776,49563776,2571
1286,02N,all,02N_all_527,51590842,51591020,51590842,178
1287,02N,all,02N_all_528,53482726,53486681,53486681,3955
1288,02N,all,02N_all_529,54215734,54216398,54215734,664
1289,02N,all,02N_all_530,54457750,54461029,54460059,3279
1290,02N,all,02N_all_531,55132669,55132839,55132837,170
1291,02N,all,02N_all_532,55360402,55360461,55360402,59
1292,02N,all,02N_all_533,55402277,55402379,55402277,102
1293,02N,all,02N_all_534,55403140,55403773,55403315,633
1294,02N,all,02N_all_535,55409402,55421181,55409402,11779
1295,02N,all,02N_all_536,55424202,55424217,55424217,15
1296,02N,all,02N_all_537,55531721,55547227,55533158,15506
1297,02N,all,02N_all_538,56116365,56117606,56117606,1241
1298,02N,all,02N_all_539,56121734,56132849,56132770,11115
1299,02N,all,02N_all_540,56434036,56437426,56437293,3390
1300,02N,all,02N_all_541,63453907,63453976,63453976,69
1301,02N,all,02N_all_542,63459507,63460526,63459507,1019
1302,02N,all,02N_all_543,63965579,63965668,63965668,89
1303,02N,all,02N_all_544,64185183,64185444,64185444,261
1304,02N,all,02N_all_545,65060502,65060509,65060502,7
1305,02N,all,02N_all_546,69205825,69207565,69207565,1740
1306,02N,all,02N_all_547,69594641,69599414,69598369,4773
1307,02N,all,02N_all_548,69677274,69677854,69677854,580
1308,02N,all,02N_all_549,69689404,69691285,69689404,1881
1309,02N,all,02N_all_550,69790864,69791183,69790864,319
1310,02N,all,02N_all_551,69967371,69967378,69967378,7
1311,02N,all,02N_all_552,69977142,69978273,69978130,1131
1312,03K,all,03K_all_1,1095991,1096282,1096282,291
1313,03K,all,03K_all_2,1966207,1966231,1966207,24
1314,03K,all,03K_all_3,2848491,2853811,2848491,5320
1315,03K,all,03K_all_4,5731089,5731157,5731089,68
1316,03K,all,03K_all_5,6872009,6872139,6872139,130
1317,03K,all,03K_all_6,8171516,8179873,8171727,8357
1318,03K,all,03K_all_7,8266006,8267640,8266006,1634
1319,03K,all,03K_all_8,8357684,8357964,8357964,280
1320,03K,all,03K_all_9,8359283,8360742,8360742,1459
1321,03K,all,03K_all_10,9251679,9252405,9251679,726
1322,03K,all,03K_all_11,11633481,11634472,11634472,991
1323,03K,all,03K_all_12,11911979,11921687,11918193,9708
1324,03K,all,03K_all_13,12867564,12867860,12867793,296
1325,03K,all,03K_all_14,12878792,12879102,12879102,310
1326,03K,all,03K_all_15,12998279,13000473,12999892,2194
1327,03K,all,03K_all_16,13093218,13099318,13094121,6100
1328,03K,all,03K_all_17,13104416,13106778,13106495,2362
1329,03K,all,03K_all_18,13108078,13108947,13108947,869
1330,03K,all,03K_all_19,13110549,13111449,13110549,900
1331,03K,all,03K_all_20,13133501,13133888,13133888,387
1332,03K,all,03K_all_21,13698608,13698967,13698608,359
1333,03K,all,03K_all_22,13769696,13769967,13769967,271
1334,03K,all,03K_all_23,13840634,13843556,13840634,2922
1335,03K,all,03K_all_24,14016918,14016924,14016918,6
1336,03K,all,03K_all_25,14021741,14021898,14021898,157
1337,03K,all,03K_all_26,14389629,14389654,14389654,25
1338,03K,all,03K_all_27,14480398,14481143,14480920,745
1339,03K,all,03K_all_28,14797356,14798550,14797356,1194
1340,03K,all,03K_all_29,14821954,14823091,14822447,1137
1341,03K,all,03K_all_30,14991462,14993322,14991462,1860
1342,03K,all,03K_all_31,15028754,15030610,15030389,1856
1343,03K,all,03K_all_32,15082772,15083513,15082772,741
1344,03K,all,03K_all_33,15685552,15686548,15685552,996
1345,03K,all,03K_all_34,16004396,16004590,16004590,194
1346,03K,all,03K_all_35,18853577,18860046,18855586,6469
1347,03K,all,03K_all_36,19140587,19141157,19140587,570
1348,03K,all,03K_all_37,19504806,19507897,19504806,3091
1349,03K,all,03K_all_38,20534045,20534052,20534052,7
1350,03K,all,03K_all_39,20545707,20546061,20545707,354
1351,03K,all,03K_all_40,20760689,20763161,20763161,2472
1352,03K,all,03K_all_41,21309502,21310586,21309727,1084
1353,03K,all,03K_all_42,22304462,22307644,22307379,3182
1354,03K,all,03K_all_43,22749396,22750374,22750374,978
1355,03K,all,03K_all_44,23038250,23038318,23038250,68
1356,03K,all,03K_all_45,23740983,23741750,23741750,767
1357,03K,all,03K_all_46,24663613,24664520,24663709,907
1358,03K,all,03K_all_47,25037271,25037330,25037271,59
1359,03K,all,03K_all_48,27043226,27043269,27043226,43
1360,03K,all,03K_all_49,27082695,27085875,27085875,3180
1361,03K,all,03K_all_50,35631369,35631884,35631884,515
1362,03K,all,03K_all_51,35633452,35634387,35634387,935
1363,03K,all,03K_all_52,35636982,35638358,35637348,1376
1364,03K,all,03K_all_53,35639504,35640009,35639504,505
1365,03K,all,03K_all_54,35641676,35645340,35643926,3664
1366,03K,all,03K_all_55,35646294,35647118,35646996,824
1367,03K,all,03K_all_56,35651479,35652621,35651479,1142
1368,03K,all,03K_all_57,36889448,36889481,36889448,33
1369,03K,all,03K_all_58,39402011,39402085,39402085,74
1370,03K,all,03K_all_59,40845191,40845256,40845191,65
1371,03K,all,03K_all_60,42507689,42508103,42508103,414
1372,03K,all,03K_all_61,42918423,42918688,42918466,265
1373,03K,all,03K_all_62,42927548,42927555,42927548,7
1374,03K,all,03K_all_63,42954196,42977450,42975453,23254
1375,03K,all,03K_all_64,42978588,42979440,42979282,852
1376,03K,all,03K_all_65,42987404,42987874,42987404,470
1377,03K,all,03K_all_66,42988788,42989642,42988935,854
1378,03K,all,03K_all_67,42991612,42992553,42992552,941
1379,03K,all,03K_all_68,42994444,42996864,42994458,2420
1380,03K,all,03K_all_69,43006105,43006193,43006127,88
1381,03K,all,03K_all_70,43008086,43010673,43008086,2587
1382,03K,all,03K_all_71,43011376,43011458,43011376,82
1383,03K,all,03K_all_72,43015789,43016258,43016107,469
1384,03K,all,03K_all_73,43032135,43032348,43032301,213
1385,03K,all,03K_all_74,43032966,43032979,43032966,13
1386,03K,all,03K_all_75,43033609,43033725,43033725,116
1387,03K,all,03K_all_76,43045540,43047343,43046150,1803
1388,03K,all,03K_all_77,43048780,43051341,43048780,2561
1389,03K,all,03K_all_78,43060816,43061728,43061728,912
1390,03K,all,03K_all_79,43310730,43317968,43314067,7238
1391,03K,all,03K_all_80,43349055,43349216,43349216,161
1392,03K,all,03K_all_81,43354718,43354799,43354718,81
1393,03K,all,03K_all_82,43366302,43366461,43366302,159
1394,03K,all,03K_all_83,43389203,43391191,43389203,1988
1395,03K,all,03K_all_84,43452240,43454019,43453367,1779
1396,03K,all,03K_all_85,43455087,43459031,43457428,3944
1397,03K,all,03K_all_86,43460463,43460762,43460762,299
1398,03K,all,03K_all_87,43461844,43462637,43462269,793
1399,03K,all,03K_all_88,43468623,43475626,43470711,7003
1400,03K,all,03K_all_89,43484252,43486766,43484535,2514
1401,03K,all,03K_all_90,43488735,43489197,43489197,462
1402,03K,all,03K_all_91,44888925,44889152,44888925,227
1403,03K,all,03K_all_92,49969476,49969542,49969542,66
1404,03K,all,03K_all_93,62209422,62209453,62209453,31
1405,03K,all,03K_all_94,62231235,62231533,62231235,298
1406,03K,all,03K_all_95,64210239,64210285,64210285,46
1407,03N,all,03N_all_1,1457347,1466100,1462538,8753
1408,03N,all,03N_all_2,6083489,6083608,6083608,119
1409,03N,all,03N_all_3,6968463,6968834,6968834,371
1410,03N,all,03N_all_4,7751290,7757035,7752407,5745
1411,03N,all,03N_all_5,7757977,7758608,7758608,631
1412,03N,all,03N_all_6,7759694,7760864,7759694,1170
1413,03N,all,03N_all_7,7762629,7762877,7762629,248
1414,03N,all,03N_all_8,7764386,7764498,7764386,112
1415,03N,all,03N_all_9,7767360,7782692,7767360,15332
1416,03N,all,03N_all_10,7788507,7806889,7806889,18382
1417,03N,all,03N_all_11,7876040,7878314,7876725,2274
1418,03N,all,03N_all_12,8312719,8313726,8312787,1007
1419,03N,all,03N_all_13,8322332,8331164,8328646,8832
1420,03N,all,03N_all_14,9198146,9198416,9198416,270
1421,03N,all,03N_all_15,9209007,9209877,9209788,870
1422,03N,all,03N_all_16,13666607,13667031,13667031,424
1423,03N,all,03N_all_17,13887952,13906541,13888569,18589
1424,03N,all,03N_all_18,13910586,13911770,13910942,1184
1425,03N,all,03N_all_19,13925112,13927460,13925598,2348
1426,03N,all,03N_all_20,14037509,14052641,14046116,15132
1427,03N,all,03N_all_21,14073728,14074634,14073728,906
1428,03N,all,03N_all_22,14075504,14080254,14080254,4750
1429,03N,all,03N_all_23,14340835,14341449,14341449,614
1430,03N,all,03N_all_24,14343336,14344156,14344124,820
1431,03N,all,03N_all_25,14347254,14351853,14349801,4599
1432,03N,all,03N_all_26,14355918,14355958,14355958,40
1433,03N,all,03N_all_27,14517310,14517311,14517311,1
1434,03N,all,03N_all_28,14535326,14536717,14536717,1391
1435,03N,all,03N_all_29,15087520,15087557,15087520,37
1436,03N,all,03N_all_30,15196066,15196245,15196245,179
1437,03N,all,03N_all_31,15421099,15427733,15425125,6634
1438,03N,all,03N_all_32,15432286,15435112,15432286,2826
1439,03N,all,03N_all_33,15439471,15440050,15439471,579
1440,03N,all,03N_all_34,15442136,15442658,15442195,522
1441,03N,all,03N_all_35,15447141,15451596,15450518,4455
1442,03N,all,03N_all_36,15452415,15456632,15455578,4217
1443,03N,all,03N_all_37,16161244,16162831,16162831,1587
1444,03N,all,03N_all_38,16166170,16166859,16166859,689
1445,03N,all,03N_all_39,16183582,16185795,16185036,2213
1446,03N,all,03N_all_40,16193217,16194130,16193217,913
1447,03N,all,03N_all_41,16207135,16207582,16207135,447
1448,03N,all,03N_all_42,16288234,16288339,16288234,105
1449,03N,all,03N_all_43,16975436,16976205,16976205,769
1450,03N,all,03N_all_44,17065872,17066032,17066032,160
1451,03N,all,03N_all_45,19467372,19467713,19467372,341
1452,03N,all,03N_all_46,19504574,19505394,19504574,820
1453,03N,all,03N_all_47,19519574,19519747,19519574,173
1454,03N,all,03N_all_48,19520688,19521877,19521627,1189
1455,03N,all,03N_all_49,19523295,19524198,19523925,903
1456,03N,all,03N_all_50,19525327,19528499,19525577,3172
1457,03N,all,03N_all_51,19531723,19531872,19531860,149
1458,03N,all,03N_all_52,19668515,19668524,19668524,9
1459,03N,all,03N_all_53,19675749,19678939,19675820,3190
1460,03N,all,03N_all_54,19741254,19741399,19741254,145
1461,03N,all,03N_all_55,19789104,19789154,19789154,50
1462,03N,all,03N_all_56,19792691,19793151,19792691,460
1463,03N,all,03N_all_57,19814354,19815036,19814354,682
1464,03N,all,03N_all_58,19816213,19817313,19816213,1100
1465,03N,all,03N_all_59,19818343,19819128,19819128,785
1466,03N,all,03N_all_60,19825377,19825988,19825957,611
1467,03N,all,03N_all_61,19831123,19831698,19831698,575
1468,03N,all,03N_all_62,19835163,19836713,19835899,1550
1469,03N,all,03N_all_63,19838110,19838147,19838110,37
1470,03N,all,03N_all_64,19839337,19839406,19839406,69
1471,03N,all,03N_all_65,19839932,19840504,19839932,572
1472,03N,all,03N_all_66,19841423,19841674,19841423,251
1473,03N,all,03N_all_67,19845437,19846797,19845597,1360
1474,03N,all,03N_all_68,19847363,19847719,19847719,356
1475,03N,all,03N_all_69,19849027,19849887,19849413,860
1476,03N,all,03N_all_70,19852500,19853543,19853543,1043
1477,03N,all,03N_all_71,19855701,19856030,19856030,329
1478,03N,all,03N_all_72,19962801,19962819,19962819,18
1479,03N,all,03N_all_73,20026133,20026488,20026488,355
1480,03N,all,03N_all_74,21715960,21716509,21715960,549
1481,03N,all,03N_all_75,22213851,22214068,22213851,217
1482,03N,all,03N_all_76,22574938,22575315,22574938,377
1483,03N,all,03N_all_77,22820045,22821254,22821254,1209
1484,03N,all,03N_all_78,23124515,23126527,23125657,2012
1485,03N,all,03N_all_79,23141856,23143904,23141856,2048
1486,03N,all,03N_all_80,23149252,23153149,23151195,3897
1487,03N,all,03N_all_81,23757627,23759314,23757627,1687
1488,03N,all,03N_all_82,24126064,24129871,24126470,3807
1489,03N,all,03N_all_83,24131404,24138420,24136909,7016
1490,03N,all,03N_all_84,24805673,24805958,24805673,285
1491,03N,all,03N_all_85,25461970,25462057,25462057,87
1492,03N,all,03N_all_86,25464964,25475134,25464964,10170
1493,03N,all,03N_all_87,25482628,25483652,25482628,1024
1494,03N,all,03N_all_88,25862606,25864558,25864558,1952
1495,03N,all,03N_all_89,29869230,29872248,29872248,3018
1496,03N,all,03N_all_90,32504853,32524929,32505689,20076
1497,03N,all,03N_all_91,33201627,33201856,33201856,229
1498,03N,all,03N_all_92,33207176,33208853,33207650,1677
1499,03N,all,03N_all_93,33210773,33216099,33210894,5326
1500,03N,all,03N_all_94,33542273,33544186,33543965,1913
1501,03N,all,03N_all_95,33549131,33549277,33549131,146
1502,03N,all,03N_all_96,33551252,33551418,33551418,166
1503,03N,all,03N_all_97,34012853,34013391,34013391,538
1504,03N,all,03N_all_98,34125285,34126050,34126050,765
1505,03N,all,03N_all_99,34134441,34136436,34134441,1995
1506,03N,all,03N_all_100,35993066,35993082,35993066,16
1507,03N,all,03N_all_101,37859792,37860894,37859792,1102
1508,03N,all,03N_all_102,38244852,38245002,38245002,150
1509,03N,all,03N_all_103,38247845,38254036,38250056,6191
1510,03N,all,03N_all_104,38280219,38281085,38280252,866
1511,03N,all,03N_all_105,38288473,38289069,38288473,596
1512,03N,all,03N_all_106,38308168,38309474,38308656,1306
1513,03N,all,03N_all_107,38320641,38321009,38320641,368
1514,03N,all,03N_all_108,38321960,38329048,38326369,7088
1515,03N,all,03N_all_109,38340640,38340672,38340672,32
1516,03N,all,03N_all_110,39079361,39080110,39079848,749
1517,03N,all,03N_all_111,39102003,39102264,39102003,261
1518,03N,all,03N_all_112,39146970,39147218,39146970,248
1519,03N,all,03N_all_113,39488198,39488817,39488198,619
1520,03N,all,03N_all_114,39567303,39567304,39567303,1
1521,03N,all,03N_all_115,39569079,39569368,39569368,289
1522,03N,all,03N_all_116,39695481,39695653,39695653,172
1523,03N,all,03N_all_117,39828740,39829013,39828740,273
1524,03N,all,03N_all_118,40459681,40459926,40459926,245
1525,03N,all,03N_all_119,42740981,42741013,42740981,32
1526,03N,all,03N_all_120,43906532,43906650,43906532,118
1527,03N,all,03N_all_121,44613838,44614066,44613838,228
1528,03N,all,03N_all_122,51124442,51124592,51124442,150
1529,03N,all,03N_all_123,52105188,52106350,52106196,1162
1530,03N,all,03N_all_124,52116134,52116266,52116266,132
1531,03N,all,03N_all_125,53680467,53680635,53680635,168
1532,03N,all,03N_all_126,57555036,57555867,57555867,831
1533,03N,all,03N_all_127,58213319,58213328,58213326,9
1534,03N,all,03N_all_128,58569623,58569799,58569799,176
1535,03N,all,03N_all_129,68526347,68526350,68526350,3
1536,03N,all,03N_all_130,69210255,69214827,69210255,4572
1537,04K,all,04K_all_1,4614895,4618453,4617620,3558
1538,04K,all,04K_all_2,7456798,7456893,7456798,95
1539,04K,all,04K_all_3,8499588,8500384,8500384,796
1540,04K,all,04K_all_4,9781677,9785888,9782456,4211
1541,04K,all,04K_all_5,10507629,10510642,10510642,3013
1542,04K,all,04K_all_6,10522776,10526812,10526161,4036
1543,04K,all,04K_all_7,12389928,12390854,12390854,926
1544,04K,all,04K_all_8,13017896,13018803,13018803,907
1545,04K,all,04K_all_9,18737185,18737186,18737185,1
1546,04K,all,04K_all_10,18999829,19000011,19000011,182
1547,04K,all,04K_all_11,19027784,19035780,19032399,7996
1548,04K,all,04K_all_12,19045672,19049316,19045672,3644
1549,04K,all,04K_all_13,19746324,19750466,19748810,4142
1550,04K,all,04K_all_14,20096568,20103089,20097750,6521
1551,04K,all,04K_all_15,20121516,20121976,20121807,460
1552,04K,all,04K_all_16,20494619,20494677,20494677,58
1553,04K,all,04K_all_17,21459550,21460145,21460145,595
1554,04K,all,04K_all_18,21483458,21483724,21483724,266
1555,04K,all,04K_all_19,21502326,21502877,21502718,551
1556,04K,all,04K_all_20,21509169,21509586,21509169,417
1557,04K,all,04K_all_21,21510284,21511282,21511228,998
1558,04K,all,04K_all_22,21519645,21519927,21519927,282
1559,04K,all,04K_all_23,21610264,21610948,21610948,684
1560,04K,all,04K_all_24,21658003,21662126,21660654,4123
1561,04K,all,04K_all_25,21688953,21689269,21689269,316
1562,04K,all,04K_all_26,21705123,21705363,21705123,240
1563,04K,all,04K_all_27,21723780,21724653,21724305,873
1564,04K,all,04K_all_28,21793757,21794493,21794113,736
1565,04K,all,04K_all_29,21800944,21801245,21801245,301
1566,04K,all,04K_all_30,21805264,21805645,21805645,381
1567,04K,all,04K_all_31,22090498,22094659,22092515,4161
1568,04K,all,04K_all_32,22096618,22097212,22096618,594
1569,04K,all,04K_all_33,22100295,22101644,22100314,1349
1570,04K,all,04K_all_34,22103385,22106494,22105674,3109
1571,04K,all,04K_all_35,22108983,22110012,22109536,1029
1572,04K,all,04K_all_36,22112888,22130407,22129790,17519
1573,04K,all,04K_all_37,22145329,22146124,22145825,795
1574,04K,all,04K_all_38,22147873,22148832,22148246,959
1575,04K,all,04K_all_39,22152073,22152144,22152073,71
1576,04K,all,04K_all_40,22156899,22159970,22159062,3071
1577,04K,all,04K_all_41,22163403,22164275,22163562,872
1578,04K,all,04K_all_42,22166461,22167525,22167291,1064
1579,04K,all,04K_all_43,30784970,30785271,30785071,301
1580,04K,all,04K_all_44,33194401,33194590,33194401,189
1581,04K,all,04K_all_45,35693137,35693340,35693340,203
1582,04K,all,04K_all_46,38381568,38383558,38383558,1990
1583,04K,all,04K_all_47,41526632,41528352,41526632,1720
1584,04K,all,04K_all_48,42074434,42074528,42074434,94
1585,04K,all,04K_all_49,43303426,43304038,43303751,612
1586,04K,all,04K_all_50,46816565,46816729,46816723,164
1587,04N,all,04N_all_1,4175579,4175583,4175583,4
1588,04N,all,04N_all_2,11490807,11491496,11490807,689
1589,04N,all,04N_all_3,11502096,11503041,11502096,945
1590,04N,all,04N_all_4,13172755,13176092,13176092,3337
1591,04N,all,04N_all_5,13192842,13194062,13192842,1220
1592,04N,all,04N_all_6,13218348,13220150,13218701,1802
1593,04N,all,04N_all_7,13347952,13348079,13347952,127
1594,04N,all,04N_all_8,13350707,13367109,13357601,16402
1595,04N,all,04N_all_9,13369525,13369800,13369800,275
1596,04N,all,04N_all_10,13377063,13377476,13377240,413
1597,04N,all,04N_all_11,13382134,13385371,13383808,3237
1598,04N,all,04N_all_12,13414282,13420441,13417484,6159
1599,04N,all,04N_all_13,13421897,13428509,13422030,6612
1600,04N,all,04N_all_14,13437011,13437330,13437011,319
1601,04N,all,04N_all_15,13439065,13441083,13439947,2018
1602,04N,all,04N_all_16,13471487,13472908,13472908,1421
1603,04N,all,04N_all_17,13479590,13479646,13479590,56
1604,04N,all,04N_all_18,13490261,13493580,13490261,3319
1605,04N,all,04N_all_19,13494326,13494403,13494326,77
1606,04N,all,04N_all_20,13495868,13496743,13495868,875
1607,04N,all,04N_all_21,19166542,19166659,19166659,117
1608,04N,all,04N_all_22,21818095,21818623,21818321,528
1609,04N,all,04N_all_23,25419212,25437093,25437093,17881
1610,04N,all,04N_all_24,28867133,28867180,28867133,47
1611,04N,all,04N_all_25,34158966,34167462,34167462,8496
1612,04N,all,04N_all_26,34490979,34491094,34491094,115
1613,04N,all,04N_all_27,42853670,42854039,42853670,369
1614,04N,all,04N_all_28,49031917,49032412,49032412,495
1615,05K,all,05K_all_1,1790181,1790541,1790249,360
1616,05K,all,05K_all_2,2610824,2611503,2611503,679
1617,05K,all,05K_all_3,3942589,3944296,3942589,1707
1618,05K,all,05K_all_4,3958389,3959370,3958389,981
1619,05K,all,05K_all_5,4557068,4558394,4558394,1326
1620,05K,all,05K_all_6,8252418,8252454,8252418,36
1621,05K,all,05K_all_7,8477621,8477718,8477623,97
1622,05K,all,05K_all_8,8641709,8641925,8641925,216
1623,05K,all,05K_all_9,8698848,8699864,8699655,1016
1624,05K,all,05K_all_10,8794312,8796050,8795961,1738
1625,05K,all,05K_all_11,10059754,10061815,10061815,2061
1626,05K,all,05K_all_12,10847665,10847746,10847746,81
1627,05K,all,05K_all_13,12676849,12677026,12676849,177
1628,05K,all,05K_all_14,13197817,13199589,13197817,1772
1629,05K,all,05K_all_15,13213467,13213945,13213945,478
1630,05K,all,05K_all_16,13218865,13219435,13218865,570
1631,05K,all,05K_all_17,13220560,13221709,13220561,1149
1632,05K,all,05K_all_18,13222813,13223483,13222813,670
1633,05K,all,05K_all_19,13226032,13226310,13226032,278
1634,05K,all,05K_all_20,13234741,13236047,13234765,1306
1635,05K,all,05K_all_21,13268294,13268729,13268319,435
1636,05K,all,05K_all_22,13272506,13272862,13272862,356
1637,05K,all,05K_all_23,13273571,13273660,13273660,89
1638,05K,all,05K_all_24,13279950,13280238,13280164,288
1639,05K,all,05K_all_25,13283801,13284751,13284543,950
1640,05K,all,05K_all_26,13286360,13287065,13287065,705
1641,05K,all,05K_all_27,13288773,13289383,13288773,610
1642,05K,all,05K_all_28,28297774,28298265,28297774,491
1643,05K,all,05K_all_29,28416242,28416367,28416242,125
1644,05K,all,05K_all_30,31136356,31137083,31136356,727
1645,05K,all,05K_all_31,33224696,33226663,33225315,1967
1646,05K,all,05K_all_32,33694443,33694830,33694443,387
1647,05K,all,05K_all_33,34960542,34961043,34960558,501
1648,05K,all,05K_all_34,38394901,38395741,38394901,840
1649,05K,all,05K_all_35,39612695,39612774,39612774,79
1650,05K,all,05K_all_36,39640866,39642578,39640866,1712
1651,05K,all,05K_all_37,39968937,39969425,39969412,488
1652,05K,all,05K_all_38,40937364,40937400,40937364,36
1653,05K,all,05K_all_39,40944156,40947804,40947804,3648
1654,05K,all,05K_all_40,41001667,41002356,41002356,689
1655,05K,all,05K_all_41,43084928,43085753,43084928,825
1656,05K,all,05K_all_42,43502788,43503565,43503565,777
1657,05K,all,05K_all_43,46297305,46302563,46299767,5258
1658,05K,all,05K_all_44,46389785,46389837,46389785,52
1659,05K,all,05K_all_45,46442873,46443184,46442873,311
1660,05K,all,05K_all_46,46444869,46446113,46446113,1244
1661,05K,all,05K_all_47,47581287,47581326,47581287,39
1662,05K,all,05K_all_48,47657792,47658123,47658123,331
1663,05K,all,05K_all_49,48177462,48178241,48177462,779
1664,05K,all,05K_all_50,48178873,48179379,48179356,506
1665,05K,all,05K_all_51,48180787,48181010,48181010,223
1666,05K,all,05K_all_52,48190693,48191041,48190693,348
1667,05K,all,05K_all_53,48271609,48272611,48272611,1002
1668,05K,all,05K_all_54,48278708,48278870,48278870,162
1669,05K,all,05K_all_55,48394857,48395041,48394857,184
1670,05K,all,05K_all_56,49054004,49059027,49059027,5023
1671,05K,all,05K_all_57,50426497,50426604,50426604,107
1672,05K,all,05K_all_58,52708696,52710193,52708732,1497
1673,05K,all,05K_all_59,52973636,52974705,52973636,1069
1674,05K,all,05K_all_60,53309524,53309722,53309722,198
1675,05K,all,05K_all_61,53687229,53687875,53687229,646
1676,05K,all,05K_all_62,53821667,53821929,53821929,262
1677,05K,all,05K_all_63,54451984,54452328,54452217,344
1678,05K,all,05K_all_64,54608952,54619891,54608952,10939
1679,05K,all,05K_all_65,54967366,54969802,54969802,2436
1680,05K,all,05K_all_66,54984691,54985749,54984691,1058
1681,05K,all,05K_all_67,54995478,54995726,54995726,248
1682,05K,all,05K_all_68,54997890,54998013,54997890,123
1683,05K,all,05K_all_69,55043837,55043856,55043856,19
1684,05K,all,05K_all_70,55047935,55048018,55048018,83
1685,05K,all,05K_all_71,55057462,55066375,55061535,8913
1686,05K,all,05K_all_72,55071508,55081226,55072540,9718
1687,05K,all,05K_all_73,55149917,55165584,55162469,15667
1688,05K,all,05K_all_74,55175090,55176125,55175626,1035
1689,05K,all,05K_all_75,55194478,55197772,55197151,3294
1690,05K,all,05K_all_76,55198752,55199595,55198958,843
1691,05K,all,05K_all_77,55200115,55201077,55201077,962
1692,05K,all,05K_all_78,55203769,55205554,55205554,1785
1693,05K,all,05K_all_79,55475993,55476686,55475993,693
1694,05K,all,05K_all_80,55560711,55561422,55560711,711
1695,05K,all,05K_all_81,55981003,55982070,55982070,1067
1696,05K,all,05K_all_82,56025715,56025760,56025715,45
1697,05K,all,05K_all_83,56463632,56465902,56465902,2270
1698,05K,all,05K_all_84,56643618,56643639,56643639,21
1699,05K,all,05K_all_85,56923325,56923361,56923325,36
1700,05K,all,05K_all_86,58239664,58239841,58239841,177
1701,05K,all,05K_all_87,58516387,58516743,58516387,356
1702,05K,all,05K_all_88,60611695,60611882,60611851,187
1703,05N,all,05N_all_1,424445,424553,424549,108
1704,05N,all,05N_all_2,1933042,1933517,1933517,475
1705,05N,all,05N_all_3,2111333,2111545,2111405,212
1706,05N,all,05N_all_4,8409297,8409300,8409299,3
1707,05N,all,05N_all_5,8921564,8922371,8921901,807
1708,05N,all,05N_all_6,9083908,9083941,9083941,33
1709,05N,all,05N_all_7,11994254,11994272,11994254,18
1710,05N,all,05N_all_8,13081893,13082026,13081893,133
1711,05N,all,05N_all_9,16524009,16524014,16524009,5
1712,05N,all,05N_all_10,25428948,25429524,25428948,576
1713,05N,all,05N_all_11,25504909,25504929,25504909,20
1714,05N,all,05N_all_12,28051689,28052289,28052289,600
1715,05N,all,05N_all_13,28056584,28058019,28056801,1435
1716,05N,all,05N_all_14,28063350,28064018,28063350,668
1717,05N,all,05N_all_15,28064703,28064893,28064703,190
1718,05N,all,05N_all_16,28066744,28068066,28066744,1322
1719,05N,all,05N_all_17,28068740,28068844,28068801,104
1720,05N,all,05N_all_18,28081232,28082579,28082579,1347
1721,05N,all,05N_all_19,28083423,28084905,28084905,1482
1722,05N,all,05N_all_20,28909846,28912553,28910973,2707
1723,05N,all,05N_all_21,28914273,28931580,28931580,17307
1724,05N,all,05N_all_22,28945094,28946441,28945872,1347
1725,05N,all,05N_all_23,28964587,28965138,28965138,551
1726,05N,all,05N_all_24,28966037,28968602,28966037,2565
1727,05N,all,05N_all_25,28969639,28989429,28971836,19790
1728,05N,all,05N_all_26,29003168,29006693,29005584,3525
1729,05N,all,05N_all_27,29008601,29021722,29021530,13121
1730,05N,all,05N_all_28,29022669,29029166,29024346,6497
1731,05N,all,05N_all_29,29029822,29030267,29029919,445
1732,05N,all,05N_all_30,29030691,29032067,29031484,1376
1733,05N,all,05N_all_31,29052015,29052270,29052270,255
1734,05N,all,05N_all_32,29053128,29054805,29053128,1677
1735,05N,all,05N_all_33,29056413,29058425,29057692,2012
1736,05N,all,05N_all_34,29060562,29060666,29060666,104
1737,05N,all,05N_all_35,29067520,29070087,29069594,2567
1738,05N,all,05N_all_36,29073985,29077197,29074283,3212
1739,05N,all,05N_all_37,29090095,29095126,29091007,5031
1740,05N,all,05N_all_38,29096089,29102676,29100864,6587
1741,05N,all,05N_all_39,29103867,29109582,29103944,5715
1742,05N,all,05N_all_40,29111434,29111692,29111504,258
1743,05N,all,05N_all_41,29113079,29114796,29114796,1717
1744,05N,all,05N_all_42,29116512,29118012,29116512,1500
1745,05N,all,05N_all_43,29119037,29120020,29119406,983
1746,05N,all,05N_all_44,29134519,29138365,29135279,3846
1747,05N,all,05N_all_45,29163437,29167521,29164196,4084
1748,05N,all,05N_all_46,29168307,29168519,29168307,212
1749,05N,all,05N_all_47,29177666,29179400,29178371,1734
1750,05N,all,05N_all_48,29194009,29197130,29194009,3121
1751,05N,all,05N_all_49,29199343,29226129,29205565,26786
1752,05N,all,05N_all_50,29228115,29228646,29228646,531
1753,05N,all,05N_all_51,29234147,29244166,29237631,10019
1754,05N,all,05N_all_52,29245783,29250165,29247413,4382
1755,05N,all,05N_all_53,29251281,29279738,29269114,28457
1756,05N,all,05N_all_54,29281282,29282811,29282660,1529
1757,05N,all,05N_all_55,29283947,29289991,29284666,6044
1758,05N,all,05N_all_56,29292330,29293101,29292330,771
1759,05N,all,05N_all_57,29333232,29333649,29333649,417
1760,05N,all,05N_all_58,29350015,29362270,29356855,12255
1761,05N,all,05N_all_59,29382016,29397035,29382575,15019
1762,05N,all,05N_all_60,29424883,29425487,29424883,604
1763,05N,all,05N_all_61,29434864,29435347,29435074,483
1764,05N,all,05N_all_62,29437326,29440344,29438401,3018
1765,05N,all,05N_all_63,29441333,29443805,29443102,2472
1766,05N,all,05N_all_64,29448639,29448957,29448639,318
1767,05N,all,05N_all_65,29451943,29452451,29452451,508
1768,05N,all,05N_all_66,29454941,29481419,29480318,26478
1769,05N,all,05N_all_67,29482900,29484965,29483009,2065
1770,05N,all,05N_all_68,29494259,29494299,29494259,40
1771,05N,all,05N_all_69,29499432,29501475,29499432,2043
1772,05N,all,05N_all_70,29502180,29510461,29505328,8281
1773,05N,all,05N_all_71,29512942,29514717,29514380,1775
1774,05N,all,05N_all_72,29516272,29541375,29536621,25103
1775,05N,all,05N_all_73,29545066,29549173,29549126,4107
1776,05N,all,05N_all_74,29550740,29552339,29551153,1599
1777,05N,all,05N_all_75,29579116,29580542,29580119,1426
1778,05N,all,05N_all_76,29614382,29616226,29616226,1844
1779,05N,all,05N_all_77,29618748,29620522,29618978,1774
1780,05N,all,05N_all_78,29634949,29637388,29636206,2439
1781,05N,all,05N_all_79,29641182,29652004,29652004,10822
1782,05N,all,05N_all_80,29664140,29670359,29670359,6219
1783,05N,all,05N_all_81,29671838,29672274,29672274,436
1784,05N,all,05N_all_82,29674482,29676092,29676092,1610
1785,05N,all,05N_all_83,29679089,29680864,29679644,1775
1786,05N,all,05N_all_84,29694486,29695385,29695385,899
1787,05N,all,05N_all_85,29696318,29709577,29708981,13259
1788,05N,all,05N_all_86,29710625,29712865,29712027,2240
1789,05N,all,05N_all_87,29736049,29743413,29739209,7364
1790,05N,all,05N_all_88,29744504,29748387,29747582,3883
1791,05N,all,05N_all_89,29749514,29751929,29749514,2415
1792,05N,all,05N_all_90,29753100,29754958,29753506,1858
1793,05N,all,05N_all_91,29758306,29759614,29758781,1308
1794,05N,all,05N_all_92,29760661,29760728,29760661,67
1795,05N,all,05N_all_93,29761589,29793439,29793439,31850
1796,05N,all,05N_all_94,29818009,29818646,29818646,637
1797,05N,all,05N_all_95,29867810,29876837,29867810,9027
1798,05N,all,05N_all_96,29908348,29909117,29908348,769
1799,05N,all,05N_all_97,30117502,30117534,30117534,32
1800,05N,all,05N_all_98,30254713,30259951,30259951,5238
1801,05N,all,05N_all_99,30298680,30299786,30298680,1106
1802,05N,all,05N_all_100,30432272,30432996,30432272,724
1803,05N,all,05N_all_101,30434550,30440402,30434550,5852
1804,05N,all,05N_all_102,30462849,30462978,30462978,129
1805,05N,all,05N_all_103,30558734,30559094,30559094,360
1806,05N,all,05N_all_104,30695295,30695762,30695295,467
1807,05N,all,05N_all_105,30784505,30786125,30785917,1620
1808,05N,all,05N_all_106,30820658,30820698,30820698,40
1809,05N,all,05N_all_107,30824104,30827452,30824912,3348
1810,05N,all,05N_all_108,30835306,30837249,30836986,1943
1811,05N,all,05N_all_109,30839967,30840921,30840678,954
1812,05N,all,05N_all_110,30849919,30850589,30849939,670
1813,05N,all,05N_all_111,30852280,30852614,30852614,334
1814,05N,all,05N_all_112,30853708,30856413,30856413,2705
1815,05N,all,05N_all_113,30857673,30866393,30858833,8720
1816,05N,all,05N_all_114,30873637,30881703,30873735,8066
1817,05N,all,05N_all_115,30883067,30885904,30883672,2837
1818,05N,all,05N_all_116,30887232,30889353,30887869,2121
1819,05N,all,05N_all_117,30893351,30893686,30893686,335
1820,05N,all,05N_all_118,30894495,30895067,30895067,572
1821,05N,all,05N_all_119,30895859,30898704,30896270,2845
1822,05N,all,05N_all_120,30899489,30903611,30901295,4122
1823,05N,all,05N_all_121,30906638,30909109,30909109,2471
1824,05N,all,05N_all_122,30926718,30929542,30927263,2824
1825,05N,all,05N_all_123,30937440,30938279,30937440,839
1826,05N,all,05N_all_124,30941488,30943191,30942787,1703
1827,05N,all,05N_all_125,30960253,30962368,30960444,2115
1828,05N,all,05N_all_126,30972666,30975118,30974624,2452
1829,05N,all,05N_all_127,30976336,30977123,30976336,787
1830,05N,all,05N_all_128,30977946,30981001,30981001,3055
1831,05N,all,05N_all_129,30983643,30988402,30983643,4759
1832,05N,all,05N_all_130,30989340,30990684,30990684,1344
1833,05N,all,05N_all_131,30992826,30994338,30994246,1512
1834,05N,all,05N_all_132,30996597,30996659,30996597,62
1835,05N,all,05N_all_133,30997966,31006479,30999997,8513
1836,05N,all,05N_all_134,31045075,31048044,31046995,2969
1837,05N,all,05N_all_135,31049470,31050191,31049470,721
1838,05N,all,05N_all_136,31051625,31056823,31056823,5198
1839,05N,all,05N_all_137,31058804,31059080,31058804,276
1840,05N,all,05N_all_138,31161610,31167906,31161610,6296
1841,05N,all,05N_all_139,31169185,31170565,31169482,1380
1842,05N,all,05N_all_140,31171426,31174147,31172862,2721
1843,05N,all,05N_all_141,31176703,31179110,31178415,2407
1844,05N,all,05N_all_142,31180374,31181542,31180525,1168
1845,05N,all,05N_all_143,31183891,31204668,31194337,20777
1846,05N,all,05N_all_144,31210540,31213670,31210563,3130
1847,05N,all,05N_all_145,31214830,31216195,31216195,1365
1848,05N,all,05N_all_146,31216925,31217802,31216925,877
1849,05N,all,05N_all_147,31218935,31227440,31226820,8505
1850,05N,all,05N_all_148,31229973,31231765,31231765,1792
1851,05N,all,05N_all_149,31234737,31239845,31238918,5108
1852,05N,all,05N_all_150,31255387,31255494,31255494,107
1853,05N,all,05N_all_151,31257317,31259345,31259345,2028
1854,05N,all,05N_all_152,31260411,31261935,31261015,1524
1855,05N,all,05N_all_153,31263933,31264828,31264703,895
1856,05N,all,05N_all_154,31267130,31272213,31267337,5083
1857,05N,all,05N_all_155,31274365,31289017,31287152,14652
1858,05N,all,05N_all_156,31296001,31298702,31296480,2701
1859,05N,all,05N_all_157,31300049,31300693,31300049,644
1860,05N,all,05N_all_158,31333665,31340090,31333894,6425
1861,05N,all,05N_all_159,31341581,31342433,31342171,852
1862,05N,all,05N_all_160,31345720,31350359,31347096,4639
1863,05N,all,05N_all_161,31352402,31364011,31361110,11609
1864,05N,all,05N_all_162,31365235,31365664,31365235,429
1865,05N,all,05N_all_163,31367115,31370181,31369754,3066
1866,05N,all,05N_all_164,31372099,31373535,31373535,1436
1867,05N,all,05N_all_165,31375480,31377576,31377560,2096
1868,05N,all,05N_all_166,31378824,31379607,31378824,783
1869,05N,all,05N_all_167,31380367,31380492,31380492,125
1870,05N,all,05N_all_168,31383167,31385130,31384038,1963
1871,05N,all,05N_all_169,31386117,31392543,31388604,6426
1872,05N,all,05N_all_170,31396734,31397244,31396955,510
1873,05N,all,05N_all_171,31400305,31414292,31400305,13987
1874,05N,all,05N_all_172,31415951,31435182,31419338,19231
1875,05N,all,05N_all_173,31468519,31469472,31469060,953
1876,05N,all,05N_all_174,31489910,31490926,31490926,1016
1877,05N,all,05N_all_175,31493652,31500671,31500267,7019
1878,05N,all,05N_all_176,31503701,31504445,31504195,744
1879,05N,all,05N_all_177,31506102,31522957,31513866,16855
1880,05N,all,05N_all_178,31529158,31535921,31534036,6763
1881,05N,all,05N_all_179,31537350,31537362,31537362,12
1882,05N,all,05N_all_180,31540582,31543026,31541515,2444
1883,05N,all,05N_all_181,31543830,31545632,31545106,1802
1884,05N,all,05N_all_182,31546526,31547258,31546880,732
1885,05N,all,05N_all_183,31570352,31582901,31575046,12549
1886,05N,all,05N_all_184,31583841,31584100,31583841,259
1887,05N,all,05N_all_185,31585267,31585581,31585267,314
1888,05N,all,05N_all_186,31588958,31589539,31588958,581
1889,05N,all,05N_all_187,31623677,31632638,31631111,8961
1890,05N,all,05N_all_188,31634031,31634142,31634031,111
1891,05N,all,05N_all_189,31635571,31635781,31635781,210
1892,05N,all,05N_all_190,31636707,31637131,31636937,424
1893,05N,all,05N_all_191,31638348,31638604,31638348,256
1894,05N,all,05N_all_192,31641914,31648431,31641914,6517
1895,05N,all,05N_all_193,31649136,31652049,31652049,2913
1896,05N,all,05N_all_194,31652570,31656325,31656111,3755
1897,05N,all,05N_all_195,31657353,31657665,31657640,312
1898,05N,all,05N_all_196,31664618,31666137,31665732,1519
1899,05N,all,05N_all_197,31667105,31685383,31675495,18278
1900,05N,all,05N_all_198,31686270,31691701,31686270,5431
1901,05N,all,05N_all_199,31692609,31699228,31697533,6619
1902,05N,all,05N_all_200,31701270,31705653,31701270,4383
1903,05N,all,05N_all_201,31710552,31714285,31711650,3733
1904,05N,all,05N_all_202,31718071,31720838,31718114,2767
1905,05N,all,05N_all_203,31724704,31724792,31724704,88
1906,05N,all,05N_all_204,31730883,31731567,31731567,684
1907,05N,all,05N_all_205,31754752,31762168,31757614,7416
1908,05N,all,05N_all_206,31774993,31777849,31777747,2856
1909,05N,all,05N_all_207,31788313,31790666,31789486,2353
1910,05N,all,05N_all_208,31792257,31792269,31792257,12
1911,05N,all,05N_all_209,31793362,31795134,31794102,1772
1912,05N,all,05N_all_210,31796786,31798406,31798344,1620
1913,05N,all,05N_all_211,31799358,31800943,31800745,1585
1914,05N,all,05N_all_212,31802001,31809483,31804951,7482
1915,05N,all,05N_all_213,31821437,31827337,31827337,5900
1916,05N,all,05N_all_214,31853987,31856526,31855858,2539
1917,05N,all,05N_all_215,31901990,31905420,31904762,3430
1918,05N,all,05N_all_216,31907391,31908533,31908062,1142
1919,05N,all,05N_all_217,31922185,31924040,31922185,1855
1920,05N,all,05N_all_218,31924765,31927083,31926241,2318
1921,05N,all,05N_all_219,31929559,31935250,31935250,5691
1922,05N,all,05N_all_220,31936626,31937812,31937464,1186
1923,05N,all,05N_all_221,31939232,31940236,31939609,1004
1924,05N,all,05N_all_222,31945018,31953772,31953772,8754
1925,05N,all,05N_all_223,31963559,31965793,31964134,2234
1926,05N,all,05N_all_224,31967477,31968658,31967477,1181
1927,05N,all,05N_all_225,32041338,32042583,32042583,1245
1928,05N,all,05N_all_226,32044817,32045060,32044973,243
1929,05N,all,05N_all_227,32046148,32046432,32046432,284
1930,05N,all,05N_all_228,32047167,32048029,32047750,862
1931,05N,all,05N_all_229,32049096,32049148,32049096,52
1932,05N,all,05N_all_230,32050006,32051025,32050705,1019
1933,05N,all,05N_all_231,32052850,32053380,32053380,530
1934,05N,all,05N_all_232,32054912,32062011,32057116,7099
1935,05N,all,05N_all_233,32117360,32123339,32123339,5979
1936,05N,all,05N_all_234,32129454,32131510,32130250,2056
1937,05N,all,05N_all_235,32184544,32201538,32201538,16994
1938,05N,all,05N_all_236,32281337,32283234,32281945,1897
1939,05N,all,05N_all_237,32297799,32301115,32301115,3316
1940,05N,all,05N_all_238,32328669,32328699,32328669,30
1941,05N,all,05N_all_239,32330703,32332359,32332359,1656
1942,05N,all,05N_all_240,32372269,32378103,32372269,5834
1943,05N,all,05N_all_241,32544995,32554792,32554792,9797
1944,05N,all,05N_all_242,32593627,32593936,32593646,309
1945,05N,all,05N_all_243,32601597,32601845,32601845,248
1946,05N,all,05N_all_244,32750150,32751755,32750297,1605
1947,05N,all,05N_all_245,32759100,32762630,32759100,3530
1948,05N,all,05N_all_246,32797862,32800272,32800272,2410
1949,05N,all,05N_all_247,32802389,32802836,32802836,447
1950,05N,all,05N_all_248,32804301,32804768,32804768,467
1951,05N,all,05N_all_249,32825696,32825930,32825696,234
1952,05N,all,05N_all_250,32834650,32835634,32835281,984
1953,05N,all,05N_all_251,32836294,32836478,32836294,184
1954,05N,all,05N_all_252,32849344,32851138,32851057,1794
1955,05N,all,05N_all_253,32852985,32853203,32852985,218
1956,05N,all,05N_all_254,32856134,32858333,32858333,2199
1957,05N,all,05N_all_255,32897460,32897671,32897671,211
1958,05N,all,05N_all_256,32928430,32928632,32928632,202
1959,05N,all,05N_all_257,32929353,32930372,32929731,1019
1960,05N,all,05N_all_258,32931230,32933459,32933459,2229
1961,05N,all,05N_all_259,32960642,32965235,32960642,4593
1962,05N,all,05N_all_260,32970236,32972751,32970236,2515
1963,05N,all,05N_all_261,32973866,32974290,32973866,424
1964,05N,all,05N_all_262,32976789,32977093,32977093,304
1965,05N,all,05N_all_263,33001456,33001746,33001746,290
1966,05N,all,05N_all_264,33005215,33005256,33005215,41
1967,05N,all,05N_all_265,33005583,33005999,33005999,416
1968,05N,all,05N_all_266,33006884,33012869,33007470,5985
1969,05N,all,05N_all_267,33013517,33015168,33013517,1651
1970,05N,all,05N_all_268,33046842,33047038,33046842,196
1971,05N,all,05N_all_269,33063171,33066326,33064844,3155
1972,05N,all,05N_all_270,33067513,33068164,33068155,651
1973,05N,all,05N_all_271,33068687,33069276,33068687,589
1974,05N,all,05N_all_272,33082655,33084148,33083668,1493
1975,05N,all,05N_all_273,33084842,33085485,33085236,643
1976,05N,all,05N_all_274,33097174,33099927,33097417,2753
1977,05N,all,05N_all_275,33102665,33103023,33103023,358
1978,05N,all,05N_all_276,33105965,33106783,33106783,818
1979,05N,all,05N_all_277,33124346,33128872,33124346,4526
1980,05N,all,05N_all_278,33132151,33132409,33132242,258
1981,05N,all,05N_all_279,33134418,33135225,33135225,807
1982,05N,all,05N_all_280,33135857,33136627,33136611,770
1983,05N,all,05N_all_281,33137279,33142455,33141568,5176
1984,05N,all,05N_all_282,33161214,33161571,33161266,357
1985,05N,all,05N_all_283,33165783,33169366,33168874,3583
1986,05N,all,05N_all_284,33199467,33202517,33199797,3050
1987,05N,all,05N_all_285,33237230,33239035,33239035,1805
1988,05N,all,05N_all_286,33240371,33241252,33240732,881
1989,05N,all,05N_all_287,33241880,33255409,33244212,13529
1990,05N,all,05N_all_288,33256536,33257197,33256536,661
1991,05N,all,05N_all_289,33258756,33259539,33259539,783
1992,05N,all,05N_all_290,33268018,33268121,33268018,103
1993,05N,all,05N_all_291,33268958,33271503,33270722,2545
1994,05N,all,05N_all_292,33272213,33275319,33272957,3106
1995,05N,all,05N_all_293,33287505,33288273,33288256,768
1996,05N,all,05N_all_294,33291680,33295099,33291970,3419
1997,05N,all,05N_all_295,33324475,33328745,33324995,4270
1998,05N,all,05N_all_296,33329687,33330684,33330205,997
1999,05N,all,05N_all_297,33331704,33332476,33332364,772
2000,05N,all,05N_all_298,33333696,33337695,33335908,3999
2001,05N,all,05N_all_299,33340994,33346454,33342869,5460
2002,05N,all,05N_all_300,33347190,33348738,33348190,1548
2003,05N,all,05N_all_301,33350579,33352203,33350905,1624
2004,05N,all,05N_all_302,33352790,33365383,33362178,12593
2005,05N,all,05N_all_303,33366981,33368128,33366981,1147
2006,05N,all,05N_all_304,33370085,33373643,33372918,3558
2007,05N,all,05N_all_305,33375600,33375664,33375664,64
2008,05N,all,05N_all_306,33379333,33382798,33382229,3465
2009,05N,all,05N_all_307,33384035,33384825,33384035,790
2010,05N,all,05N_all_308,33385973,33395903,33389561,9930
2011,05N,all,05N_all_309,33397185,33400156,33397283,2971
2012,05N,all,05N_all_310,33402468,33402483,33402468,15
2013,05N,all,05N_all_311,33404173,33410631,33407195,6458
2014,05N,all,05N_all_312,33424186,33425099,33424322,913
2015,05N,all,05N_all_313,33427121,33430170,33427121,3049
2016,05N,all,05N_all_314,33431490,33433715,33433715,2225
2017,05N,all,05N_all_315,33435041,33436774,33435992,1733
2018,05N,all,05N_all_316,33437899,33438598,33438598,699
2019,05N,all,05N_all_317,33441626,33444009,33443747,2383
2020,05N,all,05N_all_318,33445941,33449199,33447067,3258
2021,05N,all,05N_all_319,33459359,33462836,33459359,3477
2022,05N,all,05N_all_320,33492340,33501680,33501680,9340
2023,05N,all,05N_all_321,33524676,33524920,33524920,244
2024,05N,all,05N_all_322,33663945,33663966,33663966,21
2025,05N,all,05N_all_323,33711487,33714279,33713667,2792
2026,05N,all,05N_all_324,33718252,33724334,33723416,6082
2027,05N,all,05N_all_325,33726051,33728154,33726051,2103
2028,05N,all,05N_all_326,33729524,33731270,33729983,1746
2029,05N,all,05N_all_327,33733155,33733600,33733155,445
2030,05N,all,05N_all_328,33830681,33831481,33831481,800
2031,05N,all,05N_all_329,33838721,33840973,33840973,2252
2032,05N,all,05N_all_330,36225164,36225324,36225164,160
2033,05N,all,05N_all_331,36228558,36238782,36233827,10224
2034,05N,all,05N_all_332,36244211,36244487,36244211,276
2035,05N,all,05N_all_333,36603954,36605787,36605641,1833
2036,05N,all,05N_all_334,39718674,39720588,39718790,1914
2037,05N,all,05N_all_335,39751922,39751983,39751983,61
2038,05N,all,05N_all_336,40316811,40319174,40319174,2363
2039,05N,all,05N_all_337,41277076,41277210,41277210,134
2040,05N,all,05N_all_338,41308125,41310818,41308125,2693
2041,05N,all,05N_all_339,41311668,41313489,41312980,1821
2042,05N,all,05N_all_340,41315017,41315394,41315394,377
2043,05N,all,05N_all_341,41329576,41331848,41331835,2272
2044,05N,all,05N_all_342,41339356,41348288,41344775,8932
2045,05N,all,05N_all_343,41687918,41689343,41688174,1425
2046,05N,all,05N_all_344,41738503,41738504,41738504,1
2047,05N,all,05N_all_345,41773941,41774864,41774864,923
2048,05N,all,05N_all_346,41794995,41796285,41794995,1290
2049,05N,all,05N_all_347,41826782,41831207,41826919,4425
2050,05N,all,05N_all_348,41848088,41852915,41852222,4827
2051,05N,all,05N_all_349,41865010,41865701,41865691,691
2052,05N,all,05N_all_350,42035408,42036408,42036408,1000
2053,05N,all,05N_all_351,42051251,42051660,42051251,409
2054,05N,all,05N_all_352,42574835,42575353,42574835,518
2055,05N,all,05N_all_353,44196918,44197965,44197309,1047
2056,05N,all,05N_all_354,44199690,44199729,44199690,39
2057,05N,all,05N_all_355,45974637,45978978,45975251,4341
2058,05N,all,05N_all_356,45994420,45996072,45995690,1652
2059,05N,all,05N_all_357,49350533,49351321,49351321,788
2060,05N,all,05N_all_358,49695411,49701252,49699132,5841
2061,05N,all,05N_all_359,49704117,49706396,49704117,2279
2062,05N,all,05N_all_360,50582026,50582106,50582106,80
2063,05N,all,05N_all_361,51653800,51654122,51653873,322
2064,05N,all,05N_all_362,52024362,52024389,52024389,27
2065,05N,all,05N_all_363,52776492,52779895,52779895,3403
2066,05N,all,05N_all_364,52789266,52790871,52789266,1605
2067,05N,all,05N_all_365,52794182,52794845,52794195,663
2068,05N,all,05N_all_366,52820121,52821000,52821000,879
2069,05N,all,05N_all_367,53324794,53325743,53325743,949
2070,05N,all,05N_all_368,53553639,53558970,53557189,5331
2071,05N,all,05N_all_369,57223157,57225507,57225507,2350
2072,05N,all,05N_all_370,57316712,57318539,57317741,1827
2073,05N,all,05N_all_371,57319541,57321714,57321714,2173
2074,05N,all,05N_all_372,57325110,57325123,57325110,13
2075,05N,all,05N_all_373,57329926,57330054,57330054,128
2076,05N,all,05N_all_374,57333473,57334837,57333473,1364
2077,05N,all,05N_all_375,58438521,58440157,58440157,1636
2078,05N,all,05N_all_376,58452677,58453910,58452677,1233
2079,05N,all,05N_all_377,60222049,60222429,60222222,380
2080,05N,all,05N_all_378,60692193,60692244,60692244,51
2081,05N,all,05N_all_379,62151737,62152689,62152689,952
2082,05N,all,05N_all_380,62161779,62161865,62161779,86
2083,05N,all,05N_all_381,62175269,62178022,62175269,2753
2084,05N,all,05N_all_382,63124402,63125013,63125013,611
2085,05N,all,05N_all_383,63808513,63809295,63808513,782
2086,05N,all,05N_all_384,64260132,64261264,64260132,1132
2087,05N,all,05N_all_385,64334151,64336968,64335012,2817
2088,05N,all,05N_all_386,65217800,65218199,65218175,399
2089,05N,all,05N_all_387,66165341,66170502,66170502,5161
2090,05N,all,05N_all_388,72060419,72060961,72060419,542
2091,06K,all,06K_all_1,2057429,2057548,2057548,119
2092,06K,all,06K_all_2,9740602,9746780,9740602,6178
2093,06K,all,06K_all_3,10058160,10058187,10058187,27
2094,06K,all,06K_all_4,17563955,17564060,17564042,105
2095,06K,all,06K_all_5,17567286,17567529,17567529,243
2096,06K,all,06K_all_6,17575023,17576586,17576586,1563
2097,06K,all,06K_all_7,17589926,17590968,17590968,1042
2098,06K,all,06K_all_8,17591957,17591958,17591957,1
2099,06K,all,06K_all_9,17606193,17607345,17607345,1152
2100,06K,all,06K_all_10,17633183,17633490,17633183,307
2101,06K,all,06K_all_11,17657029,17657131,17657029,102
2102,06K,all,06K_all_12,17666923,17667143,17667143,220
2103,06K,all,06K_all_13,17669250,17672834,17669533,3584
2104,06K,all,06K_all_14,17678683,17678742,17678683,59
2105,06K,all,06K_all_15,25748244,25759884,25759419,11640
2106,06K,all,06K_all_16,25761413,25763592,25761413,2179
2107,06K,all,06K_all_17,27090666,27091260,27090666,594
2108,06K,all,06K_all_18,36097230,36101085,36101085,3855
2109,06K,all,06K_all_19,36731197,36734510,36733538,3313
2110,06K,all,06K_all_20,37574680,37574723,37574680,43
2111,06K,all,06K_all_21,40257482,40258297,40258297,815
2112,06K,all,06K_all_22,40462750,40463255,40463255,505
2113,06K,all,06K_all_23,41155312,41155649,41155649,337
2114,06K,all,06K_all_24,41213532,41216357,41215936,2825
2115,06K,all,06K_all_25,41234788,41235897,41235227,1109
2116,06K,all,06K_all_26,47531237,47531269,47531269,32
2117,06N,all,06N_all_1,2184295,2186935,2186835,2640
2118,06N,all,06N_all_2,6487537,6487538,6487538,1
2119,06N,all,06N_all_3,7266005,7266111,7266111,106
2120,06N,all,06N_all_4,12867534,12868795,12868597,1261
2121,06N,all,06N_all_5,20593475,20593781,20593752,306
2122,06N,all,06N_all_6,20633088,20635269,20635269,2181
2123,06N,all,06N_all_7,20637954,20638131,20637954,177
2124,06N,all,06N_all_8,20674757,20675251,20675251,494
2125,06N,all,06N_all_9,20677219,20677268,20677219,49
2126,06N,all,06N_all_10,20730816,20730923,20730816,107
2127,06N,all,06N_all_11,21067048,21067519,21067114,471
2128,06N,all,06N_all_12,23654308,23686811,23686811,32503
2129,06N,all,06N_all_13,24171784,24172130,24172130,346
2130,06N,all,06N_all_14,26905314,26905854,26905854,540
2131,06N,all,06N_all_15,26937976,26939364,26939364,1388
2132,06N,all,06N_all_16,28329876,28330129,28330129,253
2133,06N,all,06N_all_17,29069026,29069731,29069026,705
2134,06N,all,06N_all_18,29180283,29180883,29180283,600
2135,06N,all,06N_all_19,29389012,29391009,29390180,1997
2136,06N,all,06N_all_20,29407741,29412962,29412962,5221
2137,06N,all,06N_all_21,29512989,29514054,29513964,1065
2138,06N,all,06N_all_22,29527691,29527929,29527929,238
2139,06N,all,06N_all_23,29537089,29537361,29537361,272
2140,06N,all,06N_all_24,29547467,29548952,29548952,1485
2141,06N,all,06N_all_25,29553496,29555475,29555475,1979
2142,06N,all,06N_all_26,29557752,29558666,29558666,914
2143,06N,all,06N_all_27,29587576,29587954,29587954,378
2144,06N,all,06N_all_28,29589438,29590136,29589438,698
2145,06N,all,06N_all_29,29603463,29604106,29604106,643
2146,06N,all,06N_all_30,29605655,29605733,29605655,78
2147,06N,all,06N_all_31,30665805,30666146,30665805,341
2148,06N,all,06N_all_32,35685770,35687891,35685805,2121
2149,06N,all,06N_all_33,40810491,40810590,40810491,99
2150,06N,all,06N_all_34,41129284,41129461,41129461,177
2151,06N,all,06N_all_35,42245184,42246571,42246571,1387
2152,06N,all,06N_all_36,44142999,44143242,44143242,243
2153,06N,all,06N_all_37,45242126,45242135,45242126,9
2154,06N,all,06N_all_38,45284981,45287694,45286750,2713
2155,06N,all,06N_all_39,53036842,53036985,53036842,143
2156,07K,all,07K_all_1,1017328,1017330,1017328,2
2157,07K,all,07K_all_2,1284159,1288048,1285615,3889
2158,07K,all,07K_all_3,1706005,1706247,1706247,242
2159,07K,all,07K_all_4,1956460,1956807,1956807,347
2160,07K,all,07K_all_5,11200449,11200453,11200449,4
2161,07K,all,07K_all_6,14125565,14126409,14126409,844
2162,07K,all,07K_all_7,14129313,14129880,14129313,567
2163,07K,all,07K_all_8,14132284,14132304,14132284,20
2164,07K,all,07K_all_9,14135080,14135195,14135080,115
2165,07K,all,07K_all_10,14149367,14149487,14149367,120
2166,07K,all,07K_all_11,14174177,14174478,14174177,301
2167,07K,all,07K_all_12,14183830,14183852,14183852,22
2168,07K,all,07K_all_13,14195758,14196435,14195758,677
2169,07K,all,07K_all_14,14198294,14198727,14198294,433
2170,07K,all,07K_all_15,14225284,14225296,14225292,12
2171,07K,all,07K_all_16,14228818,14234457,14229824,5639
2172,07K,all,07K_all_17,14279579,14279750,14279750,171
2173,07K,all,07K_all_18,14345294,14346168,14345294,874
2174,07K,all,07K_all_19,14349562,14350412,14349562,850
2175,07K,all,07K_all_20,14514449,14515752,14515752,1303
2176,07K,all,07K_all_21,14571795,14662165,14632430,90370
2177,07K,all,07K_all_22,14668884,14697378,14668916,28494
2178,07K,all,07K_all_23,20168717,20169146,20168717,429
2179,07K,all,07K_all_24,23322669,23325692,23322811,3023
2180,07K,all,07K_all_25,23328577,23329146,23328984,569
2181,07K,all,07K_all_26,23331804,23331885,23331878,81
2182,07K,all,07K_all_27,23333610,23334742,23334541,1132
2183,07K,all,07K_all_28,23341706,23341781,23341706,75
2184,07K,all,07K_all_29,23342630,23349959,23347108,7329
2185,07K,all,07K_all_30,37616540,37616605,37616605,65
2186,07K,all,07K_all_31,38247927,38248134,38248134,207
2187,07K,all,07K_all_32,38910021,38911324,38911324,1303
2188,07K,all,07K_all_33,41193756,41195194,41195194,1438
2189,07K,all,07K_all_34,42183014,42183451,42183381,437
2190,07K,all,07K_all_35,42206381,42208032,42208032,1651
2191,07K,all,07K_all_36,42497714,42498158,42498158,444
2192,07K,all,07K_all_37,44769758,44770385,44769758,627
2193,07K,all,07K_all_38,48969981,48971552,48971552,1571
2194,07K,all,07K_all_39,50247157,50249027,50249027,1870
2195,07K,all,07K_all_40,51299531,51303425,51301389,3894
2196,07K,all,07K_all_41,52679586,52681024,52679586,1438
2197,07K,all,07K_all_42,52695221,52696347,52695655,1126
2198,07K,all,07K_all_43,52700223,52700817,52700593,594
2199,07K,all,07K_all_44,52720911,52720987,52720987,76
2200,07K,all,07K_all_45,52742074,52743323,52743323,1249
2201,07N,all,07N_all_1,36392,36393,36392,1
2202,07N,all,07N_all_2,8546776,8547568,8546776,792
2203,07N,all,07N_all_3,9969587,9969588,9969588,1
2204,07N,all,07N_all_4,12507303,12508735,12508735,1432
2205,07N,all,07N_all_5,12513985,12515067,12514012,1082
2206,07N,all,07N_all_6,12516386,12543696,12543624,27310
2207,07N,all,07N_all_7,12552395,12552642,12552642,247
2208,07N,all,07N_all_8,12554371,12554754,12554754,383
2209,07N,all,07N_all_9,12589253,12600300,12596578,11047
2210,07N,all,07N_all_10,12657894,12661551,12659021,3657
2211,07N,all,07N_all_11,12841598,12842828,12842801,1230
2212,07N,all,07N_all_12,12882437,12885088,12885049,2651
2213,07N,all,07N_all_13,12898027,12905352,12899372,7325
2214,07N,all,07N_all_14,12906451,12909694,12907901,3243
2215,07N,all,07N_all_15,12913628,12923294,12918797,9666
2216,07N,all,07N_all_16,12939382,12942606,12939463,3224
2217,07N,all,07N_all_17,12943737,12956593,12952146,12856
2218,07N,all,07N_all_18,12957274,12968159,12959562,10885
2219,07N,all,07N_all_19,12969953,12969963,12969953,10
2220,07N,all,07N_all_20,12977275,12977915,12977275,640
2221,07N,all,07N_all_21,12980132,12982904,12982571,2772
2222,07N,all,07N_all_22,13420303,13421026,13420303,723
2223,07N,all,07N_all_23,13837307,13838314,13838314,1007
2224,07N,all,07N_all_24,13871850,13872672,13872672,822
2225,07N,all,07N_all_25,13893391,13893759,13893391,368
2226,07N,all,07N_all_26,13894860,13895170,13895170,310
2227,07N,all,07N_all_27,13896621,13908373,13897552,11752
2228,07N,all,07N_all_28,14007248,14007249,14007249,1
2229,07N,all,07N_all_29,14104621,14105248,14104621,627
2230,07N,all,07N_all_30,15310291,15316128,15310565,5837
2231,07N,all,07N_all_31,15317227,15331405,15326887,14178
2232,07N,all,07N_all_32,15690915,15691051,15690915,136
2233,07N,all,07N_all_33,15693751,15694880,15694880,1129
2234,07N,all,07N_all_34,16628237,16628261,16628261,24
2235,07N,all,07N_all_35,20944860,20944861,20944861,1
2236,07N,all,07N_all_36,20955293,20959649,20959094,4356
2237,07N,all,07N_all_37,33847854,33847970,33847970,116
2238,07N,all,07N_all_38,36901226,36902804,36902516,1578
2239,07N,all,07N_all_39,36903588,36904584,36904037,996
2240,07N,all,07N_all_40,36957338,36965808,36962545,8470
2241,07N,all,07N_all_41,37009408,37011796,37009408,2388
2242,07N,all,07N_all_42,37013118,37014544,37013118,1426
2243,07N,all,07N_all_43,37015911,37020034,37019719,4123
2244,07N,all,07N_all_44,38721064,38722123,38722123,1059
2245,07N,all,07N_all_45,40135070,40135833,40135424,763
2246,07N,all,07N_all_46,42507480,42507887,42507887,407
2247,07N,all,07N_all_47,42752446,42753067,42753067,621
2248,07N,all,07N_all_48,42978158,42982403,42982403,4245
2249,07N,all,07N_all_49,43375116,43375185,43375116,69
2250,07N,all,07N_all_50,43677135,43685699,43677135,8564
2251,07N,all,07N_all_51,46114649,46115021,46114875,372
2252,07N,all,07N_all_52,46641142,46641215,46641142,73
2253,07N,all,07N_all_53,50826124,50837924,50836976,11800
2254,07N,all,07N_all_54,50838730,50842929,50840756,4199
2255,07N,all,07N_all_55,50888523,50888655,50888655,132
2256,07N,all,07N_all_56,50895674,50896697,50895674,1023
2257,08K,all,08K_all_1,1315190,1315254,1315254,64
2258,08K,all,08K_all_2,8504872,8505634,8505634,762
2259,08K,all,08K_all_3,12899657,12899895,12899895,238
2260,08K,all,08K_all_4,25746656,25747997,25746658,1341
2261,08K,all,08K_all_5,25750483,25752114,25752114,1631
2262,08K,all,08K_all_6,26046074,26046586,26046586,512
2263,08K,all,08K_all_7,26070330,26071574,26071574,1244
2264,08K,all,08K_all_8,26087874,26088410,26088410,536
2265,08K,all,08K_all_9,26114568,26114830,26114830,262
2266,08K,all,08K_all_10,26119968,26120509,26119968,541
2267,08K,all,08K_all_11,26122139,26123076,26123076,937
2268,08K,all,08K_all_12,26135386,26136500,26136500,1114
2269,08K,all,08K_all_13,26154698,26155114,26154698,416
2270,08K,all,08K_all_14,26539262,26539396,26539262,134
2271,08K,all,08K_all_15,26552781,26553075,26552781,294
2272,08K,all,08K_all_16,26589703,26589892,26589892,189
2273,08K,all,08K_all_17,26604570,26605066,26604570,496
2274,08K,all,08K_all_18,26606479,26606760,26606760,281
2275,08K,all,08K_all_19,26617096,26620824,26618073,3728
2276,08K,all,08K_all_20,26621864,26622787,26622787,923
2277,08K,all,08K_all_21,26625585,26626518,26625902,933
2278,08K,all,08K_all_22,26637175,26637472,26637472,297
2279,08K,all,08K_all_23,26649050,26649809,26649050,759
2280,08K,all,08K_all_24,26661481,26662474,26661481,993
2281,08K,all,08K_all_25,26663560,26663580,26663560,20
2282,08K,all,08K_all_26,26665801,26665858,26665801,57
2283,08K,all,08K_all_27,26666709,26667079,26666709,370
2284,08K,all,08K_all_28,26670388,26670576,26670388,188
2285,08K,all,08K_all_29,26688886,26689208,26688886,322
2286,08K,all,08K_all_30,27736692,27744560,27737366,7868
2287,08K,all,08K_all_31,27752387,27752997,27752387,610
2288,08K,all,08K_all_32,27756060,27758543,27756461,2483
2289,08K,all,08K_all_33,27769703,27769798,27769703,95
2290,08K,all,08K_all_34,27825093,27825218,27825093,125
2291,08K,all,08K_all_35,29544810,29544811,29544810,1
2292,08K,all,08K_all_36,30488293,30488691,30488427,398
2293,08K,all,08K_all_37,34913924,34921489,34913924,7565
2294,08K,all,08K_all_38,35175354,35175435,35175354,81
2295,08K,all,08K_all_39,35211683,35214141,35211683,2458
2296,08K,all,08K_all_40,35224957,35228032,35227536,3075
2297,08K,all,08K_all_41,35229553,35229937,35229553,384
2298,08K,all,08K_all_42,35232154,35232194,35232154,40
2299,08K,all,08K_all_43,35265793,35266178,35265809,385
2300,08K,all,08K_all_44,35707054,35707139,35707054,85
2301,08K,all,08K_all_45,35765382,35765657,35765657,275
2302,08K,all,08K_all_46,35767687,35767823,35767823,136
2303,08K,all,08K_all_47,36786168,36786830,36786168,662
2304,08N,all,08N_all_1,6366171,6369564,6369564,3393
2305,08N,all,08N_all_2,10901192,10901888,10901192,696
2306,08N,all,08N_all_3,10905741,10907002,10906945,1261
2307,08N,all,08N_all_4,10961146,10961390,10961272,244
2308,08N,all,08N_all_5,10967699,10968330,10968330,631
2309,08N,all,08N_all_6,10971560,10971622,10971560,62
2310,08N,all,08N_all_7,10973188,10974154,10973188,966
2311,08N,all,08N_all_8,10976141,10976605,10976605,464
2312,08N,all,08N_all_9,10977581,10977877,10977581,296
2313,08N,all,08N_all_10,10978844,10979817,10979817,973
2314,08N,all,08N_all_11,10981652,10981696,10981652,44
2315,08N,all,08N_all_12,11130861,11132816,11130861,1955
2316,08N,all,08N_all_13,11139183,11139221,11139183,38
2317,08N,all,08N_all_14,11143442,11143697,11143697,255
2318,08N,all,08N_all_15,11182299,11183190,11182664,891
2319,08N,all,08N_all_16,11184847,11189079,11185492,4232
2320,08N,all,08N_all_17,11214763,11215180,11214914,417
2321,08N,all,08N_all_18,11216063,11216219,11216063,156
2322,08N,all,08N_all_19,11233726,11234056,11233726,330
2323,08N,all,08N_all_20,11235998,11236260,11236260,262
2324,08N,all,08N_all_21,11236966,11237487,11236966,521
2325,08N,all,08N_all_22,29663595,29664164,29663595,569
2326,08N,all,08N_all_23,29705136,29705320,29705320,184
2327,08N,all,08N_all_24,29802404,29802628,29802404,224
2328,08N,all,08N_all_25,29819381,29819472,29819381,91
2329,09K,all,09K_all_1,2412393,2414170,2412393,1777
2330,09K,all,09K_all_2,2979359,2979381,2979381,22
2331,09K,all,09K_all_3,3008686,3011574,3008686,2888
2332,09K,all,09K_all_4,3465408,3466312,3465408,904
2333,09K,all,09K_all_5,3467999,3468407,3468108,408
2334,09K,all,09K_all_6,5662129,5662466,5662466,337
2335,09K,all,09K_all_7,5677028,5684868,5682338,7840
2336,09K,all,09K_all_8,5693005,5696113,5696083,3108
2337,09K,all,09K_all_9,5699852,5702341,5700904,2489
2338,09K,all,09K_all_10,5705243,5705698,5705698,455
2339,09K,all,09K_all_11,5715579,5716141,5716141,562
2340,09K,all,09K_all_12,5729386,5729893,5729386,507
2341,09K,all,09K_all_13,5736082,5736690,5736690,608
2342,09K,all,09K_all_14,5761709,5764168,5764168,2459
2343,09K,all,09K_all_15,5787539,5788638,5788638,1099
2344,09K,all,09K_all_16,5791252,5792635,5792605,1383
2345,09K,all,09K_all_17,7918891,7921674,7918891,2783
2346,09K,all,09K_all_18,7927059,7943047,7941748,15988
2347,09K,all,09K_all_19,7960177,7960275,7960275,98
2348,09K,all,09K_all_20,7989340,7989341,7989340,1
2349,09K,all,09K_all_21,7997604,7998305,7998305,701
2350,09K,all,09K_all_22,8008335,8008595,8008335,260
2351,09K,all,09K_all_23,9130876,9131220,9131220,344
2352,09K,all,09K_all_24,9587795,9589646,9587795,1851
2353,09K,all,09K_all_25,10498649,10499049,10498649,400
2354,09K,all,09K_all_26,10551615,10553643,10551615,2028
2355,09K,all,09K_all_27,10588739,10588822,10588822,83
2356,09K,all,09K_all_28,12370172,12370409,12370174,237
2357,09K,all,09K_all_29,12379035,12379961,12379745,926
2358,09K,all,09K_all_30,12555336,12555738,12555336,402
2359,09K,all,09K_all_31,13171072,13171153,13171072,81
2360,09K,all,09K_all_32,18382179,18382440,18382440,261
2361,09K,all,09K_all_33,18399230,18399906,18399261,676
2362,09K,all,09K_all_34,18741069,18742228,18741069,1159
2363,09K,all,09K_all_35,18747650,18748678,18748678,1028
2364,09K,all,09K_all_36,18860252,18861661,18861661,1409
2365,09K,all,09K_all_37,18902116,18902568,18902116,452
2366,09K,all,09K_all_38,18906684,18907227,18906684,543
2367,09K,all,09K_all_39,18920312,18920506,18920312,194
2368,09K,all,09K_all_40,18950830,18954038,18954038,3208
2369,09K,all,09K_all_41,22311892,22312486,22312486,594
2370,09K,all,09K_all_42,23005946,23007246,23006890,1300
2371,09K,all,09K_all_43,23009515,23011022,23009778,1507
2372,09K,all,09K_all_44,23015350,23020464,23018175,5114
2373,09K,all,09K_all_45,23041861,23041869,23041861,8
2374,09K,all,09K_all_46,23633102,23633482,23633102,380
2375,09K,all,09K_all_47,23650410,23650798,23650410,388
2376,09K,all,09K_all_48,23652322,23653255,23652322,933
2377,09K,all,09K_all_49,23667175,23667192,23667192,17
2378,09K,all,09K_all_50,23668782,23669777,23669053,995
2379,09K,all,09K_all_51,23671238,23672951,23672913,1713
2380,09K,all,09K_all_52,23676430,23677079,23677079,649
2381,09K,all,09K_all_53,31699395,31699804,31699804,409
2382,09K,all,09K_all_54,31734837,31735138,31734837,301
2383,09K,all,09K_all_55,31784965,31785731,31784965,766
2384,09K,all,09K_all_56,31868227,31868368,31868227,141
2385,09K,all,09K_all_57,33271983,33273410,33271983,1427
2386,09K,all,09K_all_58,33405436,33408585,33407907,3149
2387,09K,all,09K_all_59,33511551,33533836,33533836,22285
2388,09K,all,09K_all_60,33616037,33618884,33617452,2847
2389,09K,all,09K_all_61,33623233,33624212,33623998,979
2390,09K,all,09K_all_62,33625137,33633979,33633261,8842
2391,09K,all,09K_all_63,33635040,33664888,33640852,29848
2392,09K,all,09K_all_64,33680122,33701183,33682156,21061
2393,09K,all,09K_all_65,33738172,33738501,33738172,329
2394,09K,all,09K_all_66,33741558,33908565,33900709,167007
2395,09K,all,09K_all_67,33909795,33918852,33915313,9057
2396,09K,all,09K_all_68,33935541,33952690,33952690,17149
2397,09K,all,09K_all_69,33978162,33984377,33980382,6215
2398,09K,all,09K_all_70,34011733,34029869,34029540,18136
2399,09K,all,09K_all_71,34549574,34559491,34550914,9917
2400,09K,all,09K_all_72,34561225,34564436,34564436,3211
2401,09K,all,09K_all_73,34566500,34567569,34566500,1069
2402,09K,all,09K_all_74,34568628,34578888,34568896,10260
2403,09K,all,09K_all_75,34591665,34592224,34592224,559
2404,09K,all,09K_all_76,34596327,34598139,34596327,1812
2405,09K,all,09K_all_77,34604446,34605948,34605501,1502
2406,09K,all,09K_all_78,34607189,34611688,34608596,4499
2407,09K,all,09K_all_79,34614358,34619475,34619475,5117
2408,09K,all,09K_all_80,34625769,34625924,34625782,155
2409,09K,all,09K_all_81,34669862,34671240,34670704,1378
2410,09K,all,09K_all_82,34675166,34679354,34678909,4188
2411,09K,all,09K_all_83,34682822,34695648,34690681,12826
2412,09K,all,09K_all_84,34697981,34701476,34700482,3495
2413,09K,all,09K_all_85,34758335,34771876,34771876,13541
2414,09K,all,09K_all_86,34772485,34776001,34775555,3516
2415,09K,all,09K_all_87,34781425,34784589,34783076,3164
2416,09K,all,09K_all_88,34785606,34795347,34793419,9741
2417,09K,all,09K_all_89,34805107,34816084,34805189,10977
2418,09K,all,09K_all_90,34817244,34825471,34817572,8227
2419,09K,all,09K_all_91,34827040,34827457,34827040,417
2420,09K,all,09K_all_92,34833199,34833215,34833215,16
2421,09K,all,09K_all_93,34834584,34837921,34836650,3337
2422,09K,all,09K_all_94,34839034,34847164,34840976,8130
2423,09K,all,09K_all_95,34869864,35038637,34872047,168773
2424,09K,all,09K_all_96,35043040,35044401,35043930,1361
2425,09K,all,09K_all_97,35045626,35045793,35045760,167
2426,09K,all,09K_all_98,35046988,35047299,35046988,311
2427,09K,all,09K_all_99,35072270,35072567,35072270,297
2428,09K,all,09K_all_100,35073300,35075813,35074325,2513
2429,09K,all,09K_all_101,35155354,35165872,35157503,10518
2430,09K,all,09K_all_102,35182122,35230803,35217026,48681
2431,09K,all,09K_all_103,35237549,35244721,35241113,7172
2432,09K,all,09K_all_104,35247183,35247468,35247183,285
2433,09K,all,09K_all_105,35249674,35256998,35252286,7324
2434,09K,all,09K_all_106,35271868,35271948,35271924,80
2435,09K,all,09K_all_107,35273726,35275410,35273774,1684
2436,09K,all,09K_all_108,35281925,35286999,35281925,5074
2437,09K,all,09K_all_109,35291867,35293097,35292803,1230
2438,09K,all,09K_all_110,35296842,35299358,35296842,2516
2439,09K,all,09K_all_111,35313283,35313321,35313283,38
2440,09K,all,09K_all_112,35314779,35316879,35314779,2100
2441,09K,all,09K_all_113,35319968,35336581,35335290,16613
2442,09K,all,09K_all_114,35348045,35351295,35348365,3250
2443,09K,all,09K_all_115,35440588,35513249,35465373,72661
2444,09K,all,09K_all_116,35552810,35563734,35556351,10924
2445,09K,all,09K_all_117,35565791,35565798,35565798,7
2446,09K,all,09K_all_118,35568926,35592374,35584821,23448
2447,09K,all,09K_all_119,35596512,35655560,35630619,59048
2448,09K,all,09K_all_120,35722144,35723976,35722144,1832
2449,09K,all,09K_all_121,35729982,35730853,35730802,871
2450,09K,all,09K_all_122,35955784,35964831,35957245,9047
2451,09K,all,09K_all_123,36258207,36258819,36258207,612
2452,09K,all,09K_all_124,36291167,36322177,36296418,31010
2453,09K,all,09K_all_125,36381430,36389587,36385203,8157
2454,09K,all,09K_all_126,36391172,36505412,36445254,114240
2455,09K,all,09K_all_127,36901111,36901122,36901122,11
2456,09K,all,09K_all_128,36903948,36971415,36965871,67467
2457,09K,all,09K_all_129,37001898,37030279,37028224,28381
2458,09K,all,09K_all_130,37031938,37037508,37035796,5570
2459,09K,all,09K_all_131,37069729,37107230,37069729,37501
2460,09K,all,09K_all_132,37124324,37161994,37130693,37670
2461,09K,all,09K_all_133,37162960,37180232,37165097,17272
2462,09K,all,09K_all_134,37182049,37227140,37207043,45091
2463,09K,all,09K_all_135,37230380,37302366,37277065,71986
2464,09K,all,09K_all_136,37308030,37315714,37315693,7684
2465,09K,all,09K_all_137,37324511,37338928,37333212,14417
2466,09K,all,09K_all_138,37343259,37343367,37343367,108
2467,09K,all,09K_all_139,37344783,37354703,37353572,9920
2468,09K,all,09K_all_140,37367759,37453521,37444605,85762
2469,09K,all,09K_all_141,37455878,37457552,37456702,1674
2470,09K,all,09K_all_142,37458420,37460212,37460212,1792
2471,09K,all,09K_all_143,37470776,37471910,37471910,1134
2472,09K,all,09K_all_144,37473809,37474043,37473809,234
2473,09K,all,09K_all_145,37475668,37476904,37476904,1236
2474,09K,all,09K_all_146,37477982,37480077,37478102,2095
2475,09K,all,09K_all_147,37483367,37483675,37483367,308
2476,09K,all,09K_all_148,37484835,37488917,37485017,4082
2477,09K,all,09K_all_149,37490034,37490294,37490034,260
2478,09K,all,09K_all_150,37492011,37509819,37492284,17808
2479,09K,all,09K_all_151,37513852,37518949,37516911,5097
2480,09K,all,09K_all_152,37561478,37566044,37564023,4566
2481,09K,all,09K_all_153,37574715,37586575,37585771,11860
2482,09K,all,09K_all_154,37630481,37637313,37630508,6832
2483,09K,all,09K_all_155,37638731,37640140,37638731,1409
2484,09K,all,09K_all_156,37644342,37646711,37645083,2369
2485,09K,all,09K_all_157,37651945,37653193,37652062,1248
2486,09K,all,09K_all_158,37654574,37654913,37654913,339
2487,09K,all,09K_all_159,37662709,37663711,37662709,1002
2488,09K,all,09K_all_160,37665524,37670622,37670472,5098
2489,09K,all,09K_all_161,37678505,37684420,37680728,5915
2490,09K,all,09K_all_162,37685894,37690326,37685894,4432
2491,09K,all,09K_all_163,37691526,37692561,37692561,1035
2492,09K,all,09K_all_164,37697692,37704695,37699708,7003
2493,09K,all,09K_all_165,37719756,37719829,37719756,73
2494,09K,all,09K_all_166,37721538,37722323,37721631,785
2495,09K,all,09K_all_167,37723013,37726782,37726211,3769
2496,09K,all,09K_all_168,37728171,37742707,37741357,14536
2497,09K,all,09K_all_169,37743741,37744290,37743741,549
2498,09K,all,09K_all_170,37745459,37756240,37745459,10781
2499,09K,all,09K_all_171,37757999,37763663,37757999,5664
2500,09K,all,09K_all_172,37780099,37791470,37785089,11371
2501,09K,all,09K_all_173,37797500,37798891,37797664,1391
2502,09K,all,09K_all_174,37799715,37802886,37800889,3171
2503,09K,all,09K_all_175,37805583,37809222,37806485,3639
2504,09K,all,09K_all_176,37810240,37810654,37810313,414
2505,09K,all,09K_all_177,37811418,37823738,37813340,12320
2506,09K,all,09K_all_178,37834527,37835459,37835459,932
2507,09K,all,09K_all_179,37837668,37841760,37840715,4092
2508,09K,all,09K_all_180,37843052,37845025,37843578,1973
2509,09K,all,09K_all_181,37845954,37848832,37845954,2878
2510,09K,all,09K_all_182,37851302,37852199,37852199,897
2511,09K,all,09K_all_183,37869810,37871217,37870158,1407
2512,09K,all,09K_all_184,37872387,37873756,37872798,1369
2513,09K,all,09K_all_185,37875137,37876556,37876299,1419
2514,09K,all,09K_all_186,37882076,37886713,37885387,4637
2515,09K,all,09K_all_187,37888456,37888823,37888823,367
2516,09K,all,09K_all_188,37924185,37925221,37924212,1036
2517,09K,all,09K_all_189,37931094,37933475,37932037,2381
2518,09K,all,09K_all_190,37946817,37954334,37947826,7517
2519,09K,all,09K_all_191,37954799,37956191,37956191,1392
2520,09K,all,09K_all_192,37957168,37959026,37957549,1858
2521,09K,all,09K_all_193,37959843,37961470,37961470,1627
2522,09K,all,09K_all_194,37991307,37995101,37991307,3794
2523,09K,all,09K_all_195,38005461,38014621,38014621,9160
2524,09K,all,09K_all_196,38015935,38016268,38015986,333
2525,09K,all,09K_all_197,38017168,38021587,38017775,4419
2526,09K,all,09K_all_198,38022390,38024817,38022757,2427
2527,09K,all,09K_all_199,38033928,38039138,38036466,5210
2528,09K,all,09K_all_200,38044093,38058376,38052408,14283
2529,09K,all,09K_all_201,38059646,38065144,38062869,5498
2530,09K,all,09K_all_202,38065985,38069143,38067446,3158
2531,09K,all,09K_all_203,38070673,38070708,38070708,35
2532,09K,all,09K_all_204,38074602,38075144,38074602,542
2533,09K,all,09K_all_205,38081100,38081173,38081100,73
2534,09K,all,09K_all_206,38082102,38082219,38082219,117
2535,09K,all,09K_all_207,38083871,38087373,38085920,3502
2536,09K,all,09K_all_208,38118076,38122653,38121627,4577
2537,09K,all,09K_all_209,38123771,38125277,38123771,1506
2538,09K,all,09K_all_210,38126169,38131877,38131629,5708
2539,09K,all,09K_all_211,38132570,38133838,38133597,1268
2540,09K,all,09K_all_212,38135049,38136175,38135850,1126
2541,09K,all,09K_all_213,38138705,38140664,38140664,1959
2542,09K,all,09K_all_214,38151873,38155006,38153876,3133
2543,09K,all,09K_all_215,38166034,38166047,38166047,13
2544,09K,all,09K_all_216,38167247,38177846,38169425,10599
2545,09K,all,09K_all_217,38179257,38181983,38181072,2726
2546,09K,all,09K_all_218,38183755,38185098,38185098,1343
2547,09K,all,09K_all_219,38186512,38208793,38201350,22281
2548,09K,all,09K_all_220,38210243,38216506,38210537,6263
2549,09K,all,09K_all_221,38224333,38225828,38224333,1495
2550,09K,all,09K_all_222,43351396,43351932,43351932,536
2551,09K,all,09K_all_223,43353271,43358451,43353851,5180
2552,09K,all,09K_all_224,43359438,43360772,43359638,1334
2553,09K,all,09K_all_225,43635814,43637741,43637741,1927
2554,09K,all,09K_all_226,43904133,43906243,43906243,2110
2555,09K,all,09K_all_227,43908257,43910521,43909254,2264
2556,09K,all,09K_all_228,43964859,43965218,43965177,359
2557,09K,all,09K_all_229,43966504,43966964,43966504,460
2558,09K,all,09K_all_230,46090277,46096018,46096018,5741
2559,09K,all,09K_all_231,46099594,46100765,46100765,1171
2560,09K,all,09K_all_232,46102246,46103550,46102246,1304
2561,09K,all,09K_all_233,46113635,46113967,46113967,332
2562,09K,all,09K_all_234,46125437,46126076,46126076,639
2563,09K,all,09K_all_235,46163994,46164847,46164847,853
2564,09K,all,09K_all_236,46171578,46172037,46172037,459
2565,09K,all,09K_all_237,46287458,46287498,46287458,40
2566,09K,all,09K_all_238,47932560,47932679,47932679,119
2567,09K,all,09K_all_239,48242200,48243120,48243120,920
2568,09K,all,09K_all_240,48276273,48276309,48276273,36
2569,09K,all,09K_all_241,48861263,48861313,48861263,50
2570,09K,all,09K_all_242,48863749,48863971,48863749,222
2571,09K,all,09K_all_243,48868035,48868399,48868399,364
2572,09K,all,09K_all_244,49974114,49975178,49975178,1064
2573,09K,all,09K_all_245,50075070,50075628,50075628,558
2574,09K,all,09K_all_246,50278928,50279045,50278928,117
2575,09K,all,09K_all_247,51020420,51024736,51020420,4316
2576,09K,all,09K_all_248,52229895,52230172,52229895,277
2577,09K,all,09K_all_249,53940067,53940514,53940514,447
2578,09K,all,09K_all_250,53953548,53953926,53953926,378
2579,09K,all,09K_all_251,53954905,53955563,53954905,658
2580,09K,all,09K_all_252,54738463,54738522,54738522,59
2581,09K,all,09K_all_253,55613864,55616147,55616147,2283
2582,09K,all,09K_all_254,55758023,55758511,55758511,488
2583,09K,all,09K_all_255,56077274,56078907,56077274,1633
2584,09K,all,09K_all_256,56086911,56089880,56088257,2969
2585,09K,all,09K_all_257,56481976,56482527,56481976,551
2586,09K,all,09K_all_258,56972005,56973292,56973292,1287
2587,09K,all,09K_all_259,56978644,56979601,56979601,957
2588,09K,all,09K_all_260,56988627,56988778,56988627,151
2589,09K,all,09K_all_261,57006884,57008500,57008500,1616
2590,09K,all,09K_all_262,57009920,57015653,57013395,5733
2591,09K,all,09K_all_263,57017975,57026130,57021549,8155
2592,09K,all,09K_all_264,57920194,57926808,57920194,6614
2593,09K,all,09K_all_265,57937127,57937917,57937917,790
2594,09K,all,09K_all_266,57941755,57943373,57941755,1618
2595,09K,all,09K_all_267,57944572,57944700,57944572,128
2596,09K,all,09K_all_268,57946536,57947203,57946536,667
2597,09K,all,09K_all_269,58269866,58286762,58280444,16896
2598,09K,all,09K_all_270,58439634,58439841,58439634,207
2599,09K,all,09K_all_271,58881669,58889120,58888732,7451
2600,09K,all,09K_all_272,58894356,58895392,58894356,1036
2601,09K,all,09K_all_273,60029633,60031845,60031844,2212
2602,09K,all,09K_all_274,60095107,60095254,60095254,147
2603,09K,all,09K_all_275,60567818,60575579,60570180,7761
2604,09K,all,09K_all_276,60921215,60921310,60921215,95
2605,09K,all,09K_all_277,60924847,60925774,60925774,927
2606,09K,all,09K_all_278,61167867,61169089,61169089,1222
2607,09K,all,09K_all_279,61292820,61295098,61295098,2278
2608,09K,all,09K_all_280,62440948,62441396,62441396,448
2609,09K,all,09K_all_281,62446870,62448263,62448263,1393
2610,09K,all,09K_all_282,63209786,63211922,63211600,2136
2611,09K,all,09K_all_283,64013389,64016039,64014791,2650
2612,09K,all,09K_all_284,64339528,64339564,64339564,36
2613,09K,all,09K_all_285,64878302,64878323,64878302,21
2614,09K,all,09K_all_286,65162706,65193132,65193132,30426
2615,09K,all,09K_all_287,67484310,67484536,67484536,226
2616,09K,all,09K_all_288,67496517,67501145,67496551,4628
2617,09K,all,09K_all_289,67505179,67511550,67511550,6371
2618,09K,all,09K_all_290,67517491,67519335,67517660,1844
2619,09K,all,09K_all_291,68119965,68120353,68120353,388
2620,09K,all,09K_all_292,68316506,68321618,68321618,5112
2621,09K,all,09K_all_293,68377605,68377782,68377605,177
2622,09K,all,09K_all_294,68710700,68722593,68710700,11893
2623,09K,all,09K_all_295,69561322,69561412,69561322,90
2624,09K,all,09K_all_296,70766988,70773320,70773320,6332
2625,09K,all,09K_all_297,70792133,70794055,70792317,1922
2626,09N,all,09N_all_1,3883015,3883141,3883141,126
2627,09N,all,09N_all_2,5156608,5157402,5157402,794
2628,09N,all,09N_all_3,5969554,5969843,5969695,289
2629,09N,all,09N_all_4,7478980,7479978,7479933,998
2630,09N,all,09N_all_5,7487771,7488300,7487771,529
2631,09N,all,09N_all_6,7489761,7489892,7489892,131
2632,09N,all,09N_all_7,7491624,7493848,7491634,2224
2633,09N,all,09N_all_8,10225719,10228416,10228293,2697
2634,09N,all,09N_all_9,12104557,12104659,12104659,102
2635,09N,all,09N_all_10,12106374,12106908,12106908,534
2636,09N,all,09N_all_11,12117784,12120393,12117784,2609
2637,09N,all,09N_all_12,19892780,19893296,19892780,516
2638,09N,all,09N_all_13,21480787,21483235,21480925,2448
2639,09N,all,09N_all_14,21496194,21498527,21496450,2333
2640,09N,all,09N_all_15,23146824,23148676,23146853,1852
2641,09N,all,09N_all_16,23729356,23729871,23729356,515
2642,09N,all,09N_all_17,23730868,23732267,23730868,1399
2643,09N,all,09N_all_18,23734342,23734888,23734888,546
2644,09N,all,09N_all_19,23737876,23738319,23737876,443
2645,09N,all,09N_all_20,23740914,23741030,23740914,116
2646,09N,all,09N_all_21,23743292,23743587,23743292,295
2647,09N,all,09N_all_22,24888856,24888957,24888957,101
2648,09N,all,09N_all_23,24892263,24892969,24892263,706
2649,09N,all,09N_all_24,24897009,24897549,24897009,540
2650,09N,all,09N_all_25,24899942,24900493,24899942,551
2651,09N,all,09N_all_26,24902664,24903382,24902664,718
2652,09N,all,09N_all_27,24906650,24907425,24907425,775
2653,09N,all,09N_all_28,31610565,31610987,31610643,422
2654,09N,all,09N_all_29,31837002,31847298,31837002,10296
2655,09N,all,09N_all_30,37076371,37076568,37076371,197
2656,09N,all,09N_all_31,37089567,37089749,37089567,182
2657,09N,all,09N_all_32,37495692,37496040,37496040,348
2658,09N,all,09N_all_33,37589621,37589666,37589621,45
2659,09N,all,09N_all_34,37925777,37926813,37925777,1036
2660,09N,all,09N_all_35,37928512,37929082,37929082,570
2661,09N,all,09N_all_36,37941947,37942360,37941947,413
2662,09N,all,09N_all_37,38429039,38429128,38429110,89
2663,09N,all,09N_all_38,38559521,38562653,38561709,3132
2664,09N,all,09N_all_39,38620977,38621101,38620977,124
2665,09N,all,09N_all_40,39606129,39617714,39615329,11585
2666,09N,all,09N_all_41,39628317,39628756,39628317,439
2667,09N,all,09N_all_42,40097053,40097233,40097053,180
2668,09N,all,09N_all_43,40846298,40846299,40846298,1
2669,09N,all,09N_all_44,42502157,42502240,42502240,83
2670,09N,all,09N_all_45,42535040,42535514,42535514,474
2671,09N,all,09N_all_46,42556429,42556464,42556464,35
2672,09N,all,09N_all_47,42584175,42584176,42584175,1
2673,09N,all,09N_all_48,42596666,42596711,42596696,45
2674,09N,all,09N_all_49,42607296,42607756,42607756,460
2675,09N,all,09N_all_50,42632751,42633557,42632751,806
2676,09N,all,09N_all_51,42684028,42684938,42684938,910
2677,09N,all,09N_all_52,42702465,42702469,42702465,4
2678,09N,all,09N_all_53,42999862,43000492,43000492,630
2679,09N,all,09N_all_54,44037716,44037796,44037796,80
2680,09N,all,09N_all_55,50055543,50064284,50064143,8741
2681,09N,all,09N_all_56,51678539,51679024,51678539,485
2682,09N,all,09N_all_57,51729344,51729350,51729344,6
2683,09N,all,09N_all_58,51733711,51734455,51734455,744
2684,09N,all,09N_all_59,53380117,53401503,53393912,21386
2685,09N,all,09N_all_60,53405284,53407578,53405284,2294
2686,09N,all,09N_all_61,53409734,53413162,53412323,3428
2687,09N,all,09N_all_62,53424616,53430083,53426595,5467
2688,09N,all,09N_all_63,53431926,53432029,53432029,103
2689,09N,all,09N_all_64,54551186,54552193,54551186,1007
2690,09N,all,09N_all_65,54558750,54559323,54559323,573
2691,09N,all,09N_all_66,55729393,55729652,55729393,259
2692,09N,all,09N_all_67,55730234,55730505,55730234,271
2693,09N,all,09N_all_68,59951236,59951466,59951236,230
2694,09N,all,09N_all_69,63073131,63073317,63073317,186
2695,09N,all,09N_all_70,63091553,63091874,63091553,321
2696,09N,all,09N_all_71,65742202,65743425,65742202,1223
2697,09N,all,09N_all_72,65916206,65916604,65916206,398
2698,09N,all,09N_all_73,66687776,66687842,66687842,66
2699,09N,all,09N_all_74,66813894,66815173,66813894,1279
2700,09N,all,09N_all_75,66828820,66829944,66829872,1124
2701,09N,all,09N_all_76,66865245,66865936,66865245,691
2702,09N,all,09N_all_77,66874219,66885019,66884522,10800
2703,09N,all,09N_all_78,66930997,66937556,66937556,6559
2704,09N,all,09N_all_79,67352922,67353875,67353218,953
2705,09N,all,09N_all_80,67391815,67392713,67391853,898
2706,09N,all,09N_all_81,68971965,68974738,68973705,2773
2707,09N,all,09N_all_82,69933016,69933588,69933374,572
2708,09N,all,09N_all_83,70513353,70520252,70519429,6899
2709,09N,all,09N_all_84,70523091,70524781,70524172,1690
2710,09N,all,09N_all_85,70525908,70526174,70525908,266
2711,09N,all,09N_all_86,70527775,70528737,70527775,962
2712,09N,all,09N_all_87,70547896,70548373,70547896,477
2713,09N,all,09N_all_88,70554397,70554515,70554445,118
2714,09N,all,09N_all_89,70831462,70832129,70831462,667
2715,09N,all,09N_all_90,73280809,73281588,73281552,779
2716,09N,all,09N_all_91,73283973,73285452,73284198,1479
2717,09N,all,09N_all_92,73863135,73863142,73863137,7
2718,09N,all,09N_all_93,74548252,74548470,74548470,218
2719,09N,all,09N_all_94,74552614,74559862,74557054,7248
2720,09N,all,09N_all_95,74583912,74584040,74584040,128
2721,09N,all,09N_all_96,74593565,74593839,74593567,274
2722,09N,all,09N_all_97,74595208,74595229,74595208,21
2723,09N,all,09N_all_98,74601332,74601675,74601332,343
2724,09N,all,09N_all_99,74704790,74705101,74704790,311
2725,09N,all,09N_all_100,75291467,75291830,75291830,363
2726,09N,all,09N_all_101,75455374,75455417,75455374,43
2727,09N,all,09N_all_102,75594654,75598559,75595612,3905
2728,09N,all,09N_all_103,76084900,76085493,76085493,593
2729,09N,all,09N_all_104,76139266,76139350,76139350,84
2730,09N,all,09N_all_105,76220919,76221065,76221065,146
2731,09N,all,09N_all_106,79001190,79002918,79001541,1728
2732,09N,all,09N_all_107,79752466,79752763,79752763,297
2733,09N,all,09N_all_108,80482743,80483294,80483294,551
2734,09N,all,09N_all_109,80953479,80956945,80956945,3466
2735,09N,all,09N_all_110,82647516,82648771,82647655,1255
2736,09N,all,09N_all_111,82735067,82735327,82735067,260
2737,09N,all,09N_all_112,82752595,82775280,82760329,22685
2738,09N,all,09N_all_113,82850676,82851018,82851018,342
2739,09N,all,09N_all_114,82873833,82876246,82875908,2413
2740,09N,all,09N_all_115,82881117,82882702,82882684,1585
2741,09N,all,09N_all_116,82893832,82894053,82894053,221
2742,09N,all,09N_all_117,82906815,82907137,82907137,322
2743,09N,all,09N_all_118,82925934,82926771,82926771,837
2744,09N,all,09N_all_119,82945931,82948083,82945931,2152
2745,09N,all,09N_all_120,83008804,83010445,83009858,1641
2746,09N,all,09N_all_121,83014020,83014295,83014020,275
2747,09N,all,09N_all_122,83018879,83019433,83018931,554
2748,09N,all,09N_all_123,83023496,83024789,83023771,1293
2749,09N,all,09N_all_124,83044380,83047178,83044380,2798
2750,09N,all,09N_all_125,83048094,83048505,83048094,411
2751,09N,all,09N_all_126,83084968,83086825,83085309,1857
2752,01K,ec,01K_ec_1,6268273,6269200,6268330,927
2753,01K,ec,01K_ec_2,9012046,9012313,9012091,267
2754,01K,ec,01K_ec_3,22351599,22351617,22351599,18
2755,01K,ec,01K_ec_4,22355869,22356357,22356357,488
2756,01K,ec,01K_ec_5,22827144,22827349,22827144,205
2757,01K,ec,01K_ec_6,28726170,28726466,28726170,296
2758,01K,ec,01K_ec_7,34258904,34259392,34258904,488
2759,01K,ec,01K_ec_8,37964059,37964155,37964155,96
2760,01K,ec,01K_ec_9,38014220,38014316,38014220,96
2761,01K,ec,01K_ec_10,44282831,44283921,44283892,1090
2762,01K,ec,01K_ec_11,45804257,45805364,45805364,1107
2763,01K,ec,01K_ec_12,50878820,50880167,50878820,1347
2764,01K,ec,01K_ec_13,50886022,50886041,50886041,19
2765,01K,ec,01K_ec_14,50886745,50894317,50890800,7572
2766,01K,ec,01K_ec_15,50899325,50910175,50910175,10850
2767,01K,ec,01K_ec_16,51322573,51322994,51322994,421
2768,01K,ec,01K_ec_17,51335423,51340692,51337308,5269
2769,01K,ec,01K_ec_18,51738527,51742512,51742512,3985
2770,01K,ec,01K_ec_19,52876215,52877072,52877072,857
2771,01K,ec,01K_ec_20,54510502,54510663,54510502,161
2772,01N,ec,01N_ec_1,3948685,3951870,3948685,3185
2773,01N,ec,01N_ec_2,5051627,5058573,5058564,6946
2774,01N,ec,01N_ec_3,6816933,6817292,6817292,359
2775,01N,ec,01N_ec_4,6818331,6818530,6818530,199
2776,01N,ec,01N_ec_5,6819779,6820176,6820068,397
2777,01N,ec,01N_ec_6,6847258,6848464,6848464,1206
2778,01N,ec,01N_ec_7,8311953,8312204,8312204,251
2779,01N,ec,01N_ec_8,11266944,11267457,11267457,513
2780,01N,ec,01N_ec_9,12565042,12565069,12565042,27
2781,01N,ec,01N_ec_10,13668780,13668978,13668978,198
2782,01N,ec,01N_ec_11,25156493,25156597,25156493,104
2783,01N,ec,01N_ec_12,33433988,33434266,33434266,278
2784,01N,ec,01N_ec_13,34190306,34190623,34190581,317
2785,01N,ec,01N_ec_14,34342816,34344377,34344377,1561
2786,01N,ec,01N_ec_15,44004087,44006521,44006258,2434
2787,01N,ec,01N_ec_16,47885143,47885148,47885148,5
2788,01N,ec,01N_ec_17,48522321,48523774,48523235,1453
2789,01N,ec,01N_ec_18,50298771,50298778,50298771,7
2790,01N,ec,01N_ec_19,50300809,50303572,50301894,2763
2791,01N,ec,01N_ec_20,50507331,50507340,50507340,9
2792,01N,ec,01N_ec_21,51655824,51659466,51655824,3642
2793,01N,ec,01N_ec_22,52865862,52867298,52867298,1436
2794,01N,ec,01N_ec_23,52987255,52989226,52987255,1971
2795,01N,ec,01N_ec_24,52991140,52992102,52991170,962
2796,01N,ec,01N_ec_25,57198111,57198331,57198331,220
2797,01N,ec,01N_ec_26,58231660,58233719,58233719,2059
2798,01N,ec,01N_ec_27,63499601,63499603,63499601,2
2799,01N,ec,01N_ec_28,66697614,66698773,66698773,1159
2800,01N,ec,01N_ec_29,66702989,66703106,66702989,117
2801,01N,ec,01N_ec_30,66788220,66788808,66788808,588
2802,01N,ec,01N_ec_31,66978481,66978546,66978546,65
2803,01N,ec,01N_ec_32,66989109,66990856,66990856,1747
2804,02K,ec,02K_ec_1,5252293,5253760,5253760,1467
2805,02K,ec,02K_ec_2,5386200,5386371,5386248,171
2806,02K,ec,02K_ec_3,17735538,17736545,17736354,1007
2807,02K,ec,02K_ec_4,24267892,24268405,24268405,513
2808,02K,ec,02K_ec_5,24272706,24275405,24275273,2699
2809,02K,ec,02K_ec_6,24277977,24280140,24279371,2163
2810,02K,ec,02K_ec_7,24350544,24350627,24350544,83
2811,02K,ec,02K_ec_8,24430077,24431845,24430298,1768
2812,02K,ec,02K_ec_9,24433195,24433913,24433913,718
2813,02K,ec,02K_ec_10,24435838,24438922,24435838,3084
2814,02K,ec,02K_ec_11,24440050,24451684,24442392,11634
2815,02K,ec,02K_ec_12,24460397,24461310,24460397,913
2816,02K,ec,02K_ec_13,24462361,24462993,24462959,632
2817,02K,ec,02K_ec_14,24463939,24465180,24465162,1241
2818,02K,ec,02K_ec_15,24473730,24473874,24473730,144
2819,02K,ec,02K_ec_16,24475745,24479565,24479473,3820
2820,02K,ec,02K_ec_17,24481980,24485348,24484227,3368
2821,02K,ec,02K_ec_18,24486449,24486627,24486627,178
2822,02K,ec,02K_ec_19,24497868,24498632,24498632,764
2823,02K,ec,02K_ec_20,24500137,24506465,24502453,6328
2824,02K,ec,02K_ec_21,24512547,24514289,24514289,1742
2825,02K,ec,02K_ec_22,24563467,24563941,24563467,474
2826,02K,ec,02K_ec_23,24565055,24565594,24565055,539
2827,02K,ec,02K_ec_24,24566713,24567272,24566713,559
2828,02K,ec,02K_ec_25,24569205,24569747,24569205,542
2829,02K,ec,02K_ec_26,24570265,24571203,24570590,938
2830,02K,ec,02K_ec_27,24607524,24608227,24608227,703
2831,02K,ec,02K_ec_28,24608892,24609634,24608892,742
2832,02K,ec,02K_ec_29,24648224,24648455,24648224,231
2833,02K,ec,02K_ec_30,24653418,24654429,24654151,1011
2834,02K,ec,02K_ec_31,24659783,24659936,24659936,153
2835,02K,ec,02K_ec_32,25698521,25699110,25699110,589
2836,02K,ec,02K_ec_33,25789301,25790495,25789301,1194
2837,02K,ec,02K_ec_34,25802705,25803521,25803169,816
2838,02K,ec,02K_ec_35,25809248,25810611,25809248,1363
2839,02K,ec,02K_ec_36,25824015,25824090,25824015,75
2840,02K,ec,02K_ec_37,25865534,25865895,25865534,361
2841,02K,ec,02K_ec_38,25872042,25872600,25872600,558
2842,02K,ec,02K_ec_39,25893287,25893889,25893287,602
2843,02K,ec,02K_ec_40,25954450,25962029,25961073,7579
2844,02K,ec,02K_ec_41,26442142,26443170,26442328,1028
2845,02K,ec,02K_ec_42,26462487,26462833,26462487,346
2846,02K,ec,02K_ec_43,26488885,26490358,26488885,1473
2847,02K,ec,02K_ec_44,26493617,26493965,26493617,348
2848,02K,ec,02K_ec_45,26494660,26494717,26494717,57
2849,02K,ec,02K_ec_46,26552485,26553327,26552485,842
2850,02K,ec,02K_ec_47,26891884,26920240,26920240,28356
2851,02K,ec,02K_ec_48,26976636,26976640,26976636,4
2852,02K,ec,02K_ec_49,27013006,27013512,27013159,506
2853,02K,ec,02K_ec_50,27029824,27030461,27029824,637
2854,02K,ec,02K_ec_51,27031563,27040501,27031711,8938
2855,02K,ec,02K_ec_52,27045837,27046323,27046323,486
2856,02K,ec,02K_ec_53,27094315,27094363,27094315,48
2857,02K,ec,02K_ec_54,27095063,27098601,27095293,3538
2858,02K,ec,02K_ec_55,27099645,27099945,27099645,300
2859,02K,ec,02K_ec_56,27104719,27105236,27104719,517
2860,02K,ec,02K_ec_57,27124296,27124536,27124536,240
2861,02K,ec,02K_ec_58,27125333,27125723,27125723,390
2862,02K,ec,02K_ec_59,27128374,27129385,27129385,1011
2863,02K,ec,02K_ec_60,27132770,27132784,27132784,14
2864,02K,ec,02K_ec_61,27250467,27251081,27250467,614
2865,02K,ec,02K_ec_62,27252619,27253428,27253064,809
2866,02K,ec,02K_ec_63,27259888,27262287,27260777,2399
2867,02K,ec,02K_ec_64,27276781,27276925,27276781,144
2868,02K,ec,02K_ec_65,27278280,27279093,27278280,813
2869,02K,ec,02K_ec_66,27300568,27301165,27301165,597
2870,02K,ec,02K_ec_67,27343951,27344110,27344110,159
2871,02K,ec,02K_ec_68,27345603,27346988,27345870,1385
2872,02K,ec,02K_ec_69,27348898,27349175,27349175,277
2873,02K,ec,02K_ec_70,27359706,27359922,27359706,216
2874,02K,ec,02K_ec_71,27385211,27386551,27385710,1340
2875,02K,ec,02K_ec_72,27404434,27405900,27405900,1466
2876,02K,ec,02K_ec_73,27407082,27412726,27407082,5644
2877,02K,ec,02K_ec_74,27419902,27421022,27419902,1120
2878,02K,ec,02K_ec_75,27443016,27443229,27443229,213
2879,02K,ec,02K_ec_76,27451103,27452667,27451103,1564
2880,02K,ec,02K_ec_77,27528738,27529625,27529625,887
2881,02K,ec,02K_ec_78,27558431,27558516,27558431,85
2882,02K,ec,02K_ec_79,27559120,27560302,27560250,1182
2883,02K,ec,02K_ec_80,27601778,27603657,27603657,1879
2884,02K,ec,02K_ec_81,27615861,27616099,27616099,238
2885,02K,ec,02K_ec_82,27624039,27625190,27624039,1151
2886,02K,ec,02K_ec_83,27631991,27638496,27633287,6505
2887,02K,ec,02K_ec_84,27649019,27649269,27649019,250
2888,02K,ec,02K_ec_85,27657188,27657301,27657301,113
2889,02K,ec,02K_ec_86,27695150,27695861,27695292,711
2890,02K,ec,02K_ec_87,27853627,27855065,27854694,1438
2891,02K,ec,02K_ec_88,27863628,27866747,27863628,3119
2892,02K,ec,02K_ec_89,27890512,27891398,27891398,886
2893,02K,ec,02K_ec_90,27900811,27902418,27902418,1607
2894,02K,ec,02K_ec_91,27917748,27919081,27917748,1333
2895,02K,ec,02K_ec_92,27921861,27922598,27922598,737
2896,02K,ec,02K_ec_93,27926120,27928057,27928057,1937
2897,02K,ec,02K_ec_94,27942808,27943400,27942808,592
2898,02K,ec,02K_ec_95,27954146,27954293,27954146,147
2899,02K,ec,02K_ec_96,28746240,28758890,28758890,12650
2900,02K,ec,02K_ec_97,29072288,29073453,29072288,1165
2901,02K,ec,02K_ec_98,29153333,29158202,29153333,4869
2902,02K,ec,02K_ec_99,29418063,29422914,29418178,4851
2903,02K,ec,02K_ec_100,30273674,30274112,30274112,438
2904,02K,ec,02K_ec_101,30564134,30564443,30564443,309
2905,02K,ec,02K_ec_102,31515053,31515745,31515293,692
2906,02K,ec,02K_ec_103,31517196,31518116,31517916,920
2907,02K,ec,02K_ec_104,31524536,31551701,31524536,27165
2908,02K,ec,02K_ec_105,31552669,31552888,31552888,219
2909,02K,ec,02K_ec_106,31589399,31589420,31589399,21
2910,02K,ec,02K_ec_107,31592371,31592951,31592951,580
2911,02K,ec,02K_ec_108,31680791,31680801,31680801,10
2912,02K,ec,02K_ec_109,31682244,31682460,31682460,216
2913,02K,ec,02K_ec_110,31693344,31693569,31693344,225
2914,02K,ec,02K_ec_111,31695182,31695593,31695508,411
2915,02K,ec,02K_ec_112,31702585,31716257,31702585,13672
2916,02K,ec,02K_ec_113,35501134,35502847,35502847,1713
2917,02K,ec,02K_ec_114,35535484,35535955,35535484,471
2918,02K,ec,02K_ec_115,36329634,36330627,36329634,993
2919,02K,ec,02K_ec_116,36375274,36375925,36375925,651
2920,02K,ec,02K_ec_117,36384033,36385421,36384065,1388
2921,02K,ec,02K_ec_118,36503068,36504743,36503068,1675
2922,02K,ec,02K_ec_119,36530437,36530476,36530476,39
2923,02K,ec,02K_ec_120,36544959,36545660,36545660,701
2924,02K,ec,02K_ec_121,36549420,36554945,36554674,5525
2925,02K,ec,02K_ec_122,36555881,36556780,36556071,899
2926,02K,ec,02K_ec_123,36558545,36559181,36559181,636
2927,02K,ec,02K_ec_124,36560360,36560871,36560871,511
2928,02K,ec,02K_ec_125,36570684,36572793,36570684,2109
2929,02K,ec,02K_ec_126,36578228,36580573,36578847,2345
2930,02K,ec,02K_ec_127,36582043,36582099,36582043,56
2931,02K,ec,02K_ec_128,36607335,36607493,36607335,158
2932,02K,ec,02K_ec_129,36609677,36609710,36609710,33
2933,02K,ec,02K_ec_130,36695824,36696290,36695824,466
2934,02K,ec,02K_ec_131,36853382,36855474,36855474,2092
2935,02K,ec,02K_ec_132,36859836,36860219,36859836,383
2936,02K,ec,02K_ec_133,36906882,36908020,36908020,1138
2937,02K,ec,02K_ec_134,36909157,36909365,36909365,208
2938,02K,ec,02K_ec_135,40602807,40605031,40605031,2224
2939,02K,ec,02K_ec_136,42192739,42192740,42192739,1
2940,02K,ec,02K_ec_137,45768540,45768887,45768765,347
2941,02K,ec,02K_ec_138,46627540,46627851,46627851,311
2942,02K,ec,02K_ec_139,49677014,49677166,49677166,152
2943,02K,ec,02K_ec_140,50133133,50133415,50133415,282
2944,02K,ec,02K_ec_141,50647319,50648627,50647319,1308
2945,02K,ec,02K_ec_142,52606125,52606277,52606277,152
2946,02K,ec,02K_ec_143,53443733,53447771,53443733,4038
2947,02K,ec,02K_ec_144,54320772,54320847,54320847,75
2948,02K,ec,02K_ec_145,60151782,60151878,60151873,96
2949,02K,ec,02K_ec_146,62574487,62574864,62574487,377
2950,02K,ec,02K_ec_147,65839661,65845450,65845450,5789
2951,02K,ec,02K_ec_148,65852039,65853392,65853392,1353
2952,02K,ec,02K_ec_149,66963993,66964106,66963993,113
2953,02K,ec,02K_ec_150,67794072,67794578,67794355,506
2954,02N,ec,02N_ec_1,711327,711371,711371,44
2955,02N,ec,02N_ec_2,4128196,4128352,4128340,156
2956,02N,ec,02N_ec_3,4129624,4129746,4129624,122
2957,02N,ec,02N_ec_4,4130527,4130714,4130702,187
2958,02N,ec,02N_ec_5,4132202,4132603,4132603,401
2959,02N,ec,02N_ec_6,4135454,4135475,4135454,21
2960,02N,ec,02N_ec_7,5673567,5673640,5673640,73
2961,02N,ec,02N_ec_8,5683527,5685738,5685738,2211
2962,02N,ec,02N_ec_9,7260835,7260913,7260835,78
2963,02N,ec,02N_ec_10,14713776,14714525,14714177,749
2964,02N,ec,02N_ec_11,17665963,17666419,17665963,456
2965,02N,ec,02N_ec_12,18786334,18786650,18786650,316
2966,02N,ec,02N_ec_13,18886338,18886373,18886373,35
2967,02N,ec,02N_ec_14,19594705,19594709,19594709,4
2968,02N,ec,02N_ec_15,20458836,20463941,20458836,5105
2969,02N,ec,02N_ec_16,22218521,22225236,22218521,6715
2970,02N,ec,02N_ec_17,22235073,22236152,22235073,1079
2971,02N,ec,02N_ec_18,22356611,22356800,22356800,189
2972,02N,ec,02N_ec_19,22371985,22372664,22371985,679
2973,02N,ec,02N_ec_20,22442915,22443171,22442915,256
2974,02N,ec,02N_ec_21,22503424,22504823,22503424,1399
2975,02N,ec,02N_ec_22,22551156,22551212,22551212,56
2976,02N,ec,02N_ec_23,22568434,22568876,22568434,442
2977,02N,ec,02N_ec_24,22615468,22618212,22616083,2744
2978,02N,ec,02N_ec_25,22945791,22946726,22945791,935
2979,02N,ec,02N_ec_26,22949250,22954348,22954348,5098
2980,02N,ec,02N_ec_27,22958837,22960171,22959233,1334
2981,02N,ec,02N_ec_28,24427427,24427829,24427427,402
2982,02N,ec,02N_ec_29,24802659,24803007,24803007,348
2983,02N,ec,02N_ec_30,24840429,24840809,24840429,380
2984,02N,ec,02N_ec_31,24858539,24860194,24858539,1655
2985,02N,ec,02N_ec_32,24929148,24930057,24929148,909
2986,02N,ec,02N_ec_33,24962225,24964758,24962560,2533
2987,02N,ec,02N_ec_34,25010991,25011908,25011908,917
2988,02N,ec,02N_ec_35,25015463,25015833,25015833,370
2989,02N,ec,02N_ec_36,25057951,25058507,25058507,556
2990,02N,ec,02N_ec_37,25421060,25421678,25421678,618
2991,02N,ec,02N_ec_38,25457187,25457780,25457780,593
2992,02N,ec,02N_ec_39,25522653,25523567,25523567,914
2993,02N,ec,02N_ec_40,25550785,25551916,25551916,1131
2994,02N,ec,02N_ec_41,25595834,25595931,25595834,97
2995,02N,ec,02N_ec_42,26214229,26214242,26214229,13
2996,02N,ec,02N_ec_43,27758750,27759781,27759781,1031
2997,02N,ec,02N_ec_44,27760653,27760701,27760653,48
2998,02N,ec,02N_ec_45,27767365,27767735,27767365,370
2999,02N,ec,02N_ec_46,27932000,27932001,27932000,1
3000,02N,ec,02N_ec_47,28280594,28283709,28281374,3115
3001,02N,ec,02N_ec_48,28287988,28288343,28287988,355
3002,02N,ec,02N_ec_49,28461815,28462302,28462302,487
3003,02N,ec,02N_ec_50,28488279,28489106,28489106,827
3004,02N,ec,02N_ec_51,28735204,28735282,28735282,78
3005,02N,ec,02N_ec_52,28820874,28821189,28820874,315
3006,02N,ec,02N_ec_53,28839024,28839147,28839147,123
3007,02N,ec,02N_ec_54,28927353,28927478,28927353,125
3008,02N,ec,02N_ec_55,28933404,28933583,28933404,179
3009,02N,ec,02N_ec_56,28975741,28976673,28975741,932
3010,02N,ec,02N_ec_57,28980580,28981175,28980580,595
3011,02N,ec,02N_ec_58,28991446,28991687,28991687,241
3012,02N,ec,02N_ec_59,29016260,29016479,29016260,219
3013,02N,ec,02N_ec_60,29035293,29036002,29035293,709
3014,02N,ec,02N_ec_61,29048582,29049468,29049468,886
3015,02N,ec,02N_ec_62,29050759,29050976,29050976,217
3016,02N,ec,02N_ec_63,29139322,29140143,29140143,821
3017,02N,ec,02N_ec_64,29261932,29262731,29262731,799
3018,02N,ec,02N_ec_65,29264743,29265623,29264743,880
3019,02N,ec,02N_ec_66,29280047,29280418,29280418,371
3020,02N,ec,02N_ec_67,29332815,29333901,29332815,1086
3021,02N,ec,02N_ec_68,29337744,29338484,29338484,740
3022,02N,ec,02N_ec_69,29354349,29355934,29355237,1585
3023,02N,ec,02N_ec_70,29405546,29407305,29405546,1759
3024,02N,ec,02N_ec_71,29418328,29419359,29418733,1031
3025,02N,ec,02N_ec_72,29427005,29428479,29427504,1474
3026,02N,ec,02N_ec_73,29486318,29486824,29486367,506
3027,02N,ec,02N_ec_74,29617592,29617593,29617592,1
3028,02N,ec,02N_ec_75,29702465,29703823,29703823,1358
3029,02N,ec,02N_ec_76,29718339,29718914,29718339,575
3030,02N,ec,02N_ec_77,29786716,29787988,29787988,1272
3031,02N,ec,02N_ec_78,29951971,29953592,29951971,1621
3032,02N,ec,02N_ec_79,30104349,30104773,30104349,424
3033,02N,ec,02N_ec_80,30573079,30576344,30574968,3265
3034,02N,ec,02N_ec_81,31094592,31095348,31094592,756
3035,02N,ec,02N_ec_82,31124438,31125534,31124438,1096
3036,02N,ec,02N_ec_83,31126159,31126492,31126492,333
3037,02N,ec,02N_ec_84,31131179,31131474,31131179,295
3038,02N,ec,02N_ec_85,31158181,31159093,31158181,912
3039,02N,ec,02N_ec_86,31160079,31160376,31160079,297
3040,02N,ec,02N_ec_87,31246161,31246737,31246161,576
3041,02N,ec,02N_ec_88,31273156,31278109,31273324,4953
3042,02N,ec,02N_ec_89,31348732,31348738,31348738,6
3043,02N,ec,02N_ec_90,31974065,31974657,31974657,592
3044,02N,ec,02N_ec_91,31981019,31982249,31981019,1230
3045,02N,ec,02N_ec_92,32057707,32058812,32058812,1105
3046,02N,ec,02N_ec_93,32061437,32063202,32063202,1765
3047,02N,ec,02N_ec_94,33310780,33311976,33310780,1196
3048,02N,ec,02N_ec_95,33330134,33331167,33331167,1033
3049,02N,ec,02N_ec_96,33389545,33401144,33401144,11599
3050,02N,ec,02N_ec_97,33405018,33405172,33405018,154
3051,02N,ec,02N_ec_98,33410226,33410673,33410673,447
3052,02N,ec,02N_ec_99,33423785,33423850,33423850,65
3053,02N,ec,02N_ec_100,36945483,36945546,36945546,63
3054,02N,ec,02N_ec_101,44362987,44363100,44362987,113
3055,02N,ec,02N_ec_102,44660399,44662346,44660399,1947
3056,02N,ec,02N_ec_103,47726635,47726655,47726655,20
3057,02N,ec,02N_ec_104,52028873,52028879,52028873,6
3058,02N,ec,02N_ec_105,53491638,53500835,53494514,9197
3059,02N,ec,02N_ec_106,53502269,53506380,53506248,4111
3060,02N,ec,02N_ec_107,54597075,54597458,54597075,383
3061,02N,ec,02N_ec_108,55251796,55253237,55252027,1441
3062,02N,ec,02N_ec_109,55728873,55731536,55730215,2663
3063,02N,ec,02N_ec_110,55732149,55732362,55732228,213
3064,02N,ec,02N_ec_111,55733407,55745981,55741565,12574
3065,02N,ec,02N_ec_112,56762707,56765398,56762707,2691
3066,02N,ec,02N_ec_113,57976686,57977801,57977297,1115
3067,02N,ec,02N_ec_114,57978728,57978977,57978728,249
3068,02N,ec,02N_ec_115,57981693,57981801,57981693,108
3069,02N,ec,02N_ec_116,57982724,57983415,57982724,691
3070,02N,ec,02N_ec_117,57983865,57984053,57983865,188
3071,02N,ec,02N_ec_118,57985300,57985346,57985346,46
3072,02N,ec,02N_ec_119,57988543,57989242,57988543,699
3073,02N,ec,02N_ec_120,64015288,64015290,64015288,2
3074,02N,ec,02N_ec_121,65895430,65897921,65897779,2491
3075,02N,ec,02N_ec_122,69594858,69598932,69598635,4074
3076,02N,ec,02N_ec_123,69600933,69601598,69601212,665
3077,02N,ec,02N_ec_124,69602711,69603138,69602717,427
3078,02N,ec,02N_ec_125,69957914,69959896,69959896,1982
3079,02N,ec,02N_ec_126,69976026,69976082,69976026,56
3080,02N,ec,02N_ec_127,69978475,69978563,69978475,88
3081,02N,ec,02N_ec_128,70001043,70001763,70001763,720
3082,02N,ec,02N_ec_129,70009404,70009449,70009449,45
3083,02N,ec,02N_ec_130,70077777,70078023,70077777,246
3084,02N,ec,02N_ec_131,70086497,70087033,70086497,536
3085,02N,ec,02N_ec_132,70088916,70089778,70089778,862
3086,02N,ec,02N_ec_133,70134843,70135665,70135665,822
3087,02N,ec,02N_ec_134,70160360,70160645,70160645,285
3088,02N,ec,02N_ec_135,70168786,70171817,70171753,3031
3089,02N,ec,02N_ec_136,70173231,70173485,70173485,254
3090,02N,ec,02N_ec_137,70205830,70206300,70205830,470
3091,02N,ec,02N_ec_138,70219141,70219531,70219141,390
3092,03K,ec,03K_ec_1,1254752,1255149,1255149,397
3093,03K,ec,03K_ec_2,1687519,1688666,1688666,1147
3094,03K,ec,03K_ec_3,2573016,2573221,2573221,205
3095,03K,ec,03K_ec_4,5995373,5995406,5995406,33
3096,03K,ec,03K_ec_5,6011330,6011693,6011662,363
3097,03K,ec,03K_ec_6,6220096,6221306,6221306,1210
3098,03K,ec,03K_ec_7,6226908,6227512,6227512,604
3099,03K,ec,03K_ec_8,7403220,7403349,7403220,129
3100,03K,ec,03K_ec_9,7903539,7905423,7905423,1884
3101,03K,ec,03K_ec_10,7910069,7913121,7910069,3052
3102,03K,ec,03K_ec_11,8133695,8134330,8134328,635
3103,03K,ec,03K_ec_12,8273867,8279702,8278441,5835
3104,03K,ec,03K_ec_13,11854665,11856385,11856385,1720
3105,03K,ec,03K_ec_14,11912398,11919755,11912398,7357
3106,03K,ec,03K_ec_15,12216527,12225525,12225525,8998
3107,03K,ec,03K_ec_16,12227448,12228702,12228702,1254
3108,03K,ec,03K_ec_17,12274450,12274848,12274848,398
3109,03K,ec,03K_ec_18,12869721,12878925,12878809,9204
3110,03K,ec,03K_ec_19,12885694,12887201,12885694,1507
3111,03K,ec,03K_ec_20,13993644,13995035,13995035,1391
3112,03K,ec,03K_ec_21,14117839,14117882,14117839,43
3113,03K,ec,03K_ec_22,14352116,14352249,14352249,133
3114,03K,ec,03K_ec_23,14395889,14396312,14395889,423
3115,03K,ec,03K_ec_24,14408483,14410589,14408483,2106
3116,03K,ec,03K_ec_25,14474907,14475253,14474907,346
3117,03K,ec,03K_ec_26,14863061,14863467,14863061,406
3118,03K,ec,03K_ec_27,14924768,14925163,14925163,395
3119,03K,ec,03K_ec_28,15032693,15032872,15032872,179
3120,03K,ec,03K_ec_29,15401604,15401630,15401630,26
3121,03K,ec,03K_ec_30,15707644,15707913,15707644,269
3122,03K,ec,03K_ec_31,16310693,16310715,16310693,22
3123,03K,ec,03K_ec_32,16321357,16328189,16321357,6832
3124,03K,ec,03K_ec_33,16462190,16463568,16462190,1378
3125,03K,ec,03K_ec_34,16656269,16657554,16657554,1285
3126,03K,ec,03K_ec_35,17471882,17471935,17471935,53
3127,03K,ec,03K_ec_36,21309366,21310646,21310646,1280
3128,03K,ec,03K_ec_37,22733573,22733597,22733597,24
3129,03K,ec,03K_ec_38,23504867,23504900,23504867,33
3130,03K,ec,03K_ec_39,23738725,23739787,23738725,1062
3131,03K,ec,03K_ec_40,24784236,24784577,24784577,341
3132,03K,ec,03K_ec_41,24892390,24896053,24895808,3663
3133,03K,ec,03K_ec_42,24896506,24896559,24896506,53
3134,03K,ec,03K_ec_43,24902116,24903550,24903550,1434
3135,03K,ec,03K_ec_44,29107136,29107710,29107136,574
3136,03K,ec,03K_ec_45,29292835,29293396,29292835,561
3137,03K,ec,03K_ec_46,33077989,33078624,33078624,635
3138,03K,ec,03K_ec_47,35364928,35365288,35364928,360
3139,03K,ec,03K_ec_48,35370827,35371022,35370827,195
3140,03K,ec,03K_ec_49,35375708,35380446,35380446,4738
3141,03K,ec,03K_ec_50,35433378,35433794,35433378,416
3142,03K,ec,03K_ec_51,35438505,35438703,35438703,198
3143,03K,ec,03K_ec_52,35439580,35444211,35443284,4631
3144,03K,ec,03K_ec_53,35445854,35446896,35446896,1042
3145,03K,ec,03K_ec_54,35457467,35457928,35457928,461
3146,03K,ec,03K_ec_55,35472698,35474171,35473252,1473
3147,03K,ec,03K_ec_56,35475017,35475804,35475103,787
3148,03K,ec,03K_ec_57,35476816,35477506,35476816,690
3149,03K,ec,03K_ec_58,35479069,35480416,35479069,1347
3150,03K,ec,03K_ec_59,35482492,35483117,35483117,625
3151,03K,ec,03K_ec_60,35483917,35484149,35484149,232
3152,03K,ec,03K_ec_61,35558249,35558648,35558249,399
3153,03K,ec,03K_ec_62,35570920,35571228,35571228,308
3154,03K,ec,03K_ec_63,35573784,35573944,35573784,160
3155,03K,ec,03K_ec_64,35582215,35582892,35582291,677
3156,03K,ec,03K_ec_65,35584288,35593636,35593058,9348
3157,03K,ec,03K_ec_66,35601755,35601764,35601764,9
3158,03K,ec,03K_ec_67,35609920,35610311,35610311,391
3159,03K,ec,03K_ec_68,36237458,36237541,36237458,83
3160,03K,ec,03K_ec_69,36265690,36265925,36265690,235
3161,03K,ec,03K_ec_70,42367236,42368096,42368096,860
3162,03K,ec,03K_ec_71,42950959,42951016,42950959,57
3163,03K,ec,03K_ec_72,42974575,42974894,42974894,319
3164,03K,ec,03K_ec_73,42975391,42975427,42975427,36
3165,03K,ec,03K_ec_74,42976127,42976264,42976264,137
3166,03K,ec,03K_ec_75,42987774,42988486,42988486,712
3167,03K,ec,03K_ec_76,42995650,42996084,42996084,434
3168,03K,ec,03K_ec_77,42996802,42996824,42996824,22
3169,03K,ec,03K_ec_78,43010643,43011125,43011041,482
3170,03K,ec,03K_ec_79,43032455,43033285,43033234,830
3171,03K,ec,03K_ec_80,43034360,43034625,43034470,265
3172,03K,ec,03K_ec_81,43310982,43318765,43317863,7783
3173,03K,ec,03K_ec_82,43355262,43366240,43366240,10978
3174,03K,ec,03K_ec_83,43388971,43389064,43389064,93
3175,03K,ec,03K_ec_84,43452850,43453886,43453068,1036
3176,03K,ec,03K_ec_85,43457342,43459058,43458747,1716
3177,03K,ec,03K_ec_86,43460313,43461620,43460313,1307
3178,03K,ec,03K_ec_87,44548498,44548513,44548513,15
3179,03K,ec,03K_ec_88,60915023,60915548,60915023,525
3180,03K,ec,03K_ec_89,60922288,60923525,60923238,1237
3181,03K,ec,03K_ec_90,60926645,60927069,60926913,424
3182,03K,ec,03K_ec_91,63392298,63392320,63392320,22
3183,03K,ec,03K_ec_92,64211480,64214830,64214222,3350
3184,03K,ec,03K_ec_93,64218914,64219311,64219311,397
3185,03N,ec,03N_ec_1,2032425,2032446,2032425,21
3186,03N,ec,03N_ec_2,4401529,4401629,4401628,100
3187,03N,ec,03N_ec_3,9907424,9907468,9907468,44
3188,03N,ec,03N_ec_4,11426465,11426480,11426465,15
3189,03N,ec,03N_ec_5,12047171,12047346,12047346,175
3190,03N,ec,03N_ec_6,12108768,12109070,12109070,302
3191,03N,ec,03N_ec_7,13387708,13388426,13387708,718
3192,03N,ec,03N_ec_8,13525247,13525975,13525723,728
3193,03N,ec,03N_ec_9,15429814,15429962,15429820,148
3194,03N,ec,03N_ec_10,15432369,15433280,15432477,911
3195,03N,ec,03N_ec_11,15434784,15435538,15435538,754
3196,03N,ec,03N_ec_12,15437644,15439604,15437644,1960
3197,03N,ec,03N_ec_13,15442132,15442336,15442336,204
3198,03N,ec,03N_ec_14,16124631,16124632,16124632,1
3199,03N,ec,03N_ec_15,19905201,19906070,19905348,869
3200,03N,ec,03N_ec_16,19910561,19911070,19910572,509
3201,03N,ec,03N_ec_17,19911477,19911494,19911477,17
3202,03N,ec,03N_ec_18,19913239,19914186,19913997,947
3203,03N,ec,03N_ec_19,19915068,19915320,19915223,252
3204,03N,ec,03N_ec_20,21755427,21756126,21755427,699
3205,03N,ec,03N_ec_21,23048025,23048601,23048187,576
3206,03N,ec,03N_ec_22,23050155,23051132,23051041,977
3207,03N,ec,03N_ec_23,24137096,24137245,24137096,149
3208,03N,ec,03N_ec_24,26037998,26038109,26037998,111
3209,03N,ec,03N_ec_25,26080113,26080322,26080113,209
3210,03N,ec,03N_ec_26,28597974,28600361,28599502,2387
3211,03N,ec,03N_ec_27,28611965,28611985,28611965,20
3212,03N,ec,03N_ec_28,28683301,28683335,28683301,34
3213,03N,ec,03N_ec_29,30049060,30049437,30049437,377
3214,03N,ec,03N_ec_30,33871093,33873980,33871741,2887
3215,03N,ec,03N_ec_31,33934284,33934534,33934450,250
3216,03N,ec,03N_ec_32,33950582,33951045,33950582,463
3217,03N,ec,03N_ec_33,33964911,33964935,33964911,24
3218,03N,ec,03N_ec_34,33966260,33966687,33966260,427
3219,03N,ec,03N_ec_35,36860235,36860904,36860235,669
3220,03N,ec,03N_ec_36,36904040,36904431,36904431,391
3221,03N,ec,03N_ec_37,36906392,36908772,36906469,2380
3222,03N,ec,03N_ec_38,38308385,38308388,38308388,3
3223,03N,ec,03N_ec_39,38484604,38484715,38484715,111
3224,03N,ec,03N_ec_40,38526184,38526442,38526238,258
3225,03N,ec,03N_ec_41,38608015,38609990,38608015,1975
3226,03N,ec,03N_ec_42,38614353,38614480,38614480,127
3227,03N,ec,03N_ec_43,38645229,38645533,38645229,304
3228,03N,ec,03N_ec_44,38753491,38762946,38753491,9455
3229,03N,ec,03N_ec_45,38777335,38778171,38777335,836
3230,03N,ec,03N_ec_46,38888633,38888898,38888633,265
3231,03N,ec,03N_ec_47,39102486,39103068,39103068,582
3232,03N,ec,03N_ec_48,39107441,39108144,39107441,703
3233,03N,ec,03N_ec_49,39130614,39132068,39132068,1454
3234,03N,ec,03N_ec_50,39133944,39134740,39134740,796
3235,03N,ec,03N_ec_51,39506297,39506386,39506386,89
3236,03N,ec,03N_ec_52,39510347,39511081,39510437,734
3237,03N,ec,03N_ec_53,39525909,39527332,39525909,1423
3238,03N,ec,03N_ec_54,39559229,39564386,39564386,5157
3239,03N,ec,03N_ec_55,39568726,39569298,39569298,572
3240,03N,ec,03N_ec_56,39575646,39577067,39577067,1421
3241,03N,ec,03N_ec_57,39578616,39580857,39579654,2241
3242,03N,ec,03N_ec_58,39625715,39629271,39626292,3556
3243,03N,ec,03N_ec_59,39633426,39635991,39634513,2565
3244,03N,ec,03N_ec_60,39661381,39661674,39661674,293
3245,03N,ec,03N_ec_61,39664162,39665159,39665159,997
3246,03N,ec,03N_ec_62,39667123,39667611,39667123,488
3247,03N,ec,03N_ec_63,39677039,39678097,39678097,1058
3248,03N,ec,03N_ec_64,39679125,39680243,39679485,1118
3249,03N,ec,03N_ec_65,39682441,39684122,39682441,1681
3250,03N,ec,03N_ec_66,39689728,39691408,39689728,1680
3251,03N,ec,03N_ec_67,39695003,39695695,39695301,692
3252,03N,ec,03N_ec_68,39826030,39826212,39826072,182
3253,03N,ec,03N_ec_69,39893531,39894699,39894699,1168
3254,03N,ec,03N_ec_70,39914086,39914145,39914145,59
3255,03N,ec,03N_ec_71,40023345,40023379,40023345,34
3256,03N,ec,03N_ec_72,40047037,40048305,40048305,1268
3257,03N,ec,03N_ec_73,40051308,40052754,40052719,1446
3258,03N,ec,03N_ec_74,40057788,40058817,40058817,1029
3259,03N,ec,03N_ec_75,40064840,40065250,40065250,410
3260,03N,ec,03N_ec_76,40066428,40071876,40066588,5448
3261,03N,ec,03N_ec_77,40101810,40107103,40105513,5293
3262,03N,ec,03N_ec_78,40109726,40111082,40110308,1356
3263,03N,ec,03N_ec_79,40118638,40118715,40118715,77
3264,03N,ec,03N_ec_80,40207882,40215025,40215025,7143
3265,03N,ec,03N_ec_81,40217002,40221061,40219232,4059
3266,03N,ec,03N_ec_82,40227402,40230319,40227402,2917
3267,03N,ec,03N_ec_83,40245452,40248447,40248447,2995
3268,03N,ec,03N_ec_84,40249126,40249762,40249762,636
3269,03N,ec,03N_ec_85,40251330,40251750,40251597,420
3270,03N,ec,03N_ec_86,40255930,40256367,40256367,437
3271,03N,ec,03N_ec_87,40258687,40260716,40258840,2029
3272,03N,ec,03N_ec_88,40262059,40265488,40265289,3429
3273,03N,ec,03N_ec_89,40274215,40276253,40274215,2038
3274,03N,ec,03N_ec_90,40278842,40279490,40278842,648
3275,03N,ec,03N_ec_91,40281617,40284190,40283305,2573
3276,03N,ec,03N_ec_92,40285461,40285633,40285633,172
3277,03N,ec,03N_ec_93,40293358,40295299,40294165,1941
3278,03N,ec,03N_ec_94,40296880,40298016,40298016,1136
3279,03N,ec,03N_ec_95,40299812,40300154,40299812,342
3280,03N,ec,03N_ec_96,40380754,40380801,40380801,47
3281,03N,ec,03N_ec_97,40416113,40416150,40416113,37
3282,03N,ec,03N_ec_98,40433594,40436373,40435142,2779
3283,03N,ec,03N_ec_99,40453376,40455188,40453549,1812
3284,03N,ec,03N_ec_100,40462067,40463555,40463104,1488
3285,03N,ec,03N_ec_101,40471200,40472757,40472053,1557
3286,03N,ec,03N_ec_102,40505255,40509749,40506340,4494
3287,03N,ec,03N_ec_103,40512229,40514079,40513694,1850
3288,03N,ec,03N_ec_104,40519979,40522862,40521540,2883
3289,03N,ec,03N_ec_105,40567615,40568021,40568017,406
3290,03N,ec,03N_ec_106,40569331,40593331,40573352,24000
3291,03N,ec,03N_ec_107,40594992,40598857,40596815,3865
3292,03N,ec,03N_ec_108,40637438,40638009,40637780,571
3293,03N,ec,03N_ec_109,40639596,40639861,40639596,265
3294,03N,ec,03N_ec_110,40664262,40667657,40666991,3395
3295,03N,ec,03N_ec_111,40669227,40669424,40669227,197
3296,03N,ec,03N_ec_112,40670665,40676091,40673419,5426
3297,03N,ec,03N_ec_113,40677532,40687624,40678062,10092
3298,03N,ec,03N_ec_114,40691351,40692696,40691852,1345
3299,03N,ec,03N_ec_115,40694369,40702030,40694787,7661
3300,03N,ec,03N_ec_116,40717470,40724456,40718876,6986
3301,03N,ec,03N_ec_117,40728498,40730370,40728498,1872
3302,03N,ec,03N_ec_118,40757321,40757328,40757321,7
3303,03N,ec,03N_ec_119,40763226,40763994,40763226,768
3304,03N,ec,03N_ec_120,40774330,40775790,40774989,1460
3305,03N,ec,03N_ec_121,40794957,40803459,40795558,8502
3306,03N,ec,03N_ec_122,40810922,40811345,40811345,423
3307,03N,ec,03N_ec_123,40814204,40814234,40814204,30
3308,03N,ec,03N_ec_124,40815060,40815494,40815060,434
3309,03N,ec,03N_ec_125,40816754,40817251,40817251,497
3310,03N,ec,03N_ec_126,40819351,40819701,40819351,350
3311,03N,ec,03N_ec_127,40839686,40840397,40839686,711
3312,03N,ec,03N_ec_128,40841897,40843956,40842266,2059
3313,03N,ec,03N_ec_129,40846109,40847221,40847221,1112
3314,03N,ec,03N_ec_130,40850229,40851451,40850229,1222
3315,03N,ec,03N_ec_131,40857537,40861511,40860752,3974
3316,03N,ec,03N_ec_132,40862499,40864251,40863092,1752
3317,03N,ec,03N_ec_133,40922657,40924283,40923701,1626
3318,03N,ec,03N_ec_134,40925216,40931163,40926185,5947
3319,03N,ec,03N_ec_135,40932684,40947009,40945463,14325
3320,03N,ec,03N_ec_136,40953449,40953893,40953746,444
3321,03N,ec,03N_ec_137,40954599,40955321,40955321,722
3322,03N,ec,03N_ec_138,40955865,40956814,40956055,949
3323,03N,ec,03N_ec_139,40958213,40959123,40958750,910
3324,03N,ec,03N_ec_140,41000749,41005275,41005275,4526
3325,03N,ec,03N_ec_141,41012617,41013897,41012617,1280
3326,03N,ec,03N_ec_142,41016598,41019148,41019148,2550
3327,03N,ec,03N_ec_143,41020372,41022982,41022455,2610
3328,03N,ec,03N_ec_144,41025652,41026641,41026641,989
3329,03N,ec,03N_ec_145,41039926,41043667,41039926,3741
3330,03N,ec,03N_ec_146,41052415,41068442,41068442,16027
3331,03N,ec,03N_ec_147,41071775,41090096,41071831,18321
3332,03N,ec,03N_ec_148,41102206,41103159,41103159,953
3333,03N,ec,03N_ec_149,41177500,41197698,41197166,20198
3334,03N,ec,03N_ec_150,41199688,41201187,41200795,1499
3335,03N,ec,03N_ec_151,41202156,41202471,41202156,315
3336,03N,ec,03N_ec_152,41204750,41207052,41204798,2302
3337,03N,ec,03N_ec_153,41210098,41210573,41210140,475
3338,03N,ec,03N_ec_154,41214431,41214981,41214467,550
3339,03N,ec,03N_ec_155,41229171,41229429,41229242,258
3340,03N,ec,03N_ec_156,41230722,41245736,41230722,15014
3341,03N,ec,03N_ec_157,41257416,41259622,41257416,2206
3342,03N,ec,03N_ec_158,41404868,41405071,41405029,203
3343,03N,ec,03N_ec_159,41553011,41554866,41553408,1855
3344,03N,ec,03N_ec_160,41568419,41568470,41568419,51
3345,03N,ec,03N_ec_161,41722452,41728367,41728054,5915
3346,03N,ec,03N_ec_162,41729739,41729798,41729739,59
3347,03N,ec,03N_ec_163,41789139,41802414,41789139,13275
3348,03N,ec,03N_ec_164,41814119,41827746,41814250,13627
3349,03N,ec,03N_ec_165,41850298,41850934,41850298,636
3350,03N,ec,03N_ec_166,41864377,41869157,41869157,4780
3351,03N,ec,03N_ec_167,41871607,41872201,41872201,594
3352,03N,ec,03N_ec_168,41873715,41874572,41873715,857
3353,03N,ec,03N_ec_169,41888599,41889223,41888789,624
3354,03N,ec,03N_ec_170,41891212,41896778,41891797,5566
3355,03N,ec,03N_ec_171,41897554,41897888,41897554,334
3356,03N,ec,03N_ec_172,41907669,41907812,41907669,143
3357,03N,ec,03N_ec_173,41909683,41910420,41910420,737
3358,03N,ec,03N_ec_174,41937801,41938004,41937801,203
3359,03N,ec,03N_ec_175,41963578,41964437,41964437,859
3360,03N,ec,03N_ec_176,41982810,41984019,41983526,1209
3361,03N,ec,03N_ec_177,41991277,42000271,41991277,8994
3362,03N,ec,03N_ec_178,42005928,42028083,42009634,22155
3363,03N,ec,03N_ec_179,42033048,42044217,42041740,11169
3364,03N,ec,03N_ec_180,42071811,42073871,42071811,2060
3365,03N,ec,03N_ec_181,42075171,42075988,42075988,817
3366,03N,ec,03N_ec_182,42081161,42085204,42082652,4043
3367,03N,ec,03N_ec_183,42086963,42087377,42087363,414
3368,03N,ec,03N_ec_184,42090297,42092477,42091384,2180
3369,03N,ec,03N_ec_185,42093823,42094521,42094521,698
3370,03N,ec,03N_ec_186,42097454,42099227,42098890,1773
3371,03N,ec,03N_ec_187,42101451,42101457,42101457,6
3372,03N,ec,03N_ec_188,42103660,42109753,42106759,6093
3373,03N,ec,03N_ec_189,42119426,42122111,42119961,2685
3374,03N,ec,03N_ec_190,42131694,42131706,42131706,12
3375,03N,ec,03N_ec_191,42143365,42151534,42151140,8169
3376,03N,ec,03N_ec_192,42152614,42155142,42153734,2528
3377,03N,ec,03N_ec_193,42162768,42164082,42163780,1314
3378,03N,ec,03N_ec_194,42165392,42170282,42166776,4890
3379,03N,ec,03N_ec_195,42233468,42236574,42234022,3106
3380,03N,ec,03N_ec_196,42240075,42241799,42241696,1724
3381,03N,ec,03N_ec_197,42242843,42243490,42242843,647
3382,03N,ec,03N_ec_198,42262816,42265781,42263453,2965
3383,03N,ec,03N_ec_199,42276583,42276591,42276583,8
3384,03N,ec,03N_ec_200,44153725,44154232,44154232,507
3385,03N,ec,03N_ec_201,44155786,44156574,44156234,788
3386,03N,ec,03N_ec_202,44159029,44159120,44159029,91
3387,03N,ec,03N_ec_203,44289920,44290393,44289920,473
3388,03N,ec,03N_ec_204,44507752,44507767,44507752,15
3389,03N,ec,03N_ec_205,44665138,44665565,44665403,427
3390,03N,ec,03N_ec_206,45300256,45300487,45300487,231
3391,03N,ec,03N_ec_207,46222146,46222731,46222674,585
3392,03N,ec,03N_ec_208,46225078,46226304,46225339,1226
3393,03N,ec,03N_ec_209,46226919,46227820,46227339,901
3394,03N,ec,03N_ec_210,46228784,46237397,46237070,8613
3395,03N,ec,03N_ec_211,46238824,46239714,46239350,890
3396,03N,ec,03N_ec_212,46242625,46242943,46242943,318
3397,03N,ec,03N_ec_213,46243783,46245860,46245860,2077
3398,03N,ec,03N_ec_214,48749975,48750162,48749975,187
3399,03N,ec,03N_ec_215,48750960,48751731,48750960,771
3400,03N,ec,03N_ec_216,48946657,48946851,48946657,194
3401,03N,ec,03N_ec_217,48960834,48960943,48960943,109
3402,03N,ec,03N_ec_218,50888808,50889537,50889537,729
3403,03N,ec,03N_ec_219,50892013,50892346,50892013,333
3404,03N,ec,03N_ec_220,50894065,50894372,50894372,307
3405,03N,ec,03N_ec_221,51124825,51125811,51125811,986
3406,03N,ec,03N_ec_222,52792645,52793066,52792645,421
3407,03N,ec,03N_ec_223,52814569,52815047,52815047,478
3408,03N,ec,03N_ec_224,52817720,52818172,52818172,452
3409,03N,ec,03N_ec_225,52821079,52821687,52821687,608
3410,03N,ec,03N_ec_226,55297015,55301454,55300167,4439
3411,03N,ec,03N_ec_227,57205598,57205687,57205598,89
3412,03N,ec,03N_ec_228,57665374,57665418,57665418,44
3413,03N,ec,03N_ec_229,60034395,60034964,60034395,569
3414,03N,ec,03N_ec_230,60442657,60443449,60443449,792
3415,03N,ec,03N_ec_231,61933172,61935276,61934373,2104
3416,03N,ec,03N_ec_232,62011055,62011354,62011144,299
3417,03N,ec,03N_ec_233,63621935,63622050,63621935,115
3418,03N,ec,03N_ec_234,65986895,65990648,65990648,3753
3419,03N,ec,03N_ec_235,65994477,65995156,65994477,679
3420,03N,ec,03N_ec_236,67233494,67236659,67236659,3165
3421,03N,ec,03N_ec_237,69420396,69420528,69420479,132
3422,04K,ec,04K_ec_1,4344620,4345275,4344922,655
3423,04K,ec,04K_ec_2,4350922,4351255,4351255,333
3424,04K,ec,04K_ec_3,6227918,6229382,6228284,1464
3425,04K,ec,04K_ec_4,6450664,6451937,6450664,1273
3426,04K,ec,04K_ec_5,9949531,9950446,9950446,915
3427,04K,ec,04K_ec_6,10072082,10076918,10072082,4836
3428,04K,ec,04K_ec_7,10078818,10078953,10078818,135
3429,04K,ec,04K_ec_8,10085804,10086119,10086119,315
3430,04K,ec,04K_ec_9,23361814,23362874,23361814,1060
3431,04K,ec,04K_ec_10,28269115,28269153,28269134,38
3432,04K,ec,04K_ec_11,28273310,28273513,28273513,203
3433,04K,ec,04K_ec_12,28301028,28301119,28301028,91
3434,04K,ec,04K_ec_13,30229230,30229510,30229292,280
3435,04K,ec,04K_ec_14,31859869,31859871,31859871,2
3436,04K,ec,04K_ec_15,33846008,33846562,33846562,554
3437,04K,ec,04K_ec_16,33847257,33847307,33847257,50
3438,04K,ec,04K_ec_17,36330762,36330805,36330762,43
3439,04K,ec,04K_ec_18,36935722,36938230,36938214,2508
3440,04K,ec,04K_ec_19,37472269,37472306,37472297,37
3441,04K,ec,04K_ec_20,39517679,39517855,39517679,176
3442,04K,ec,04K_ec_21,40791233,40794316,40791852,3083
3443,04K,ec,04K_ec_22,40805865,40806140,40805865,275
3444,04N,ec,04N_ec_1,4756465,4766729,4756507,10264
3445,04N,ec,04N_ec_2,11120532,11121452,11120532,920
3446,04N,ec,04N_ec_3,11730907,11731046,11730907,139
3447,04N,ec,04N_ec_4,13177743,13178783,13177743,1040
3448,04N,ec,04N_ec_5,13182563,13183962,13183382,1399
3449,04N,ec,04N_ec_6,13185643,13186219,13185643,576
3450,04N,ec,04N_ec_7,13193719,13195293,13193719,1574
3451,04N,ec,04N_ec_8,13416051,13418062,13418062,2011
3452,04N,ec,04N_ec_9,13423345,13427218,13427218,3873
3453,04N,ec,04N_ec_10,14451566,14451841,14451566,275
3454,04N,ec,04N_ec_11,15111439,15122205,15122205,10766
3455,04N,ec,04N_ec_12,15130590,15140738,15134736,10148
3456,04N,ec,04N_ec_13,15142956,15142969,15142959,13
3457,04N,ec,04N_ec_14,17193579,17193876,17193579,297
3458,04N,ec,04N_ec_15,18763159,18764074,18763571,915
3459,04N,ec,04N_ec_16,19259516,19260989,19260989,1473
3460,04N,ec,04N_ec_17,20321358,20321991,20321358,633
3461,04N,ec,04N_ec_18,20323326,20324110,20324110,784
3462,04N,ec,04N_ec_19,20324645,20324687,20324645,42
3463,04N,ec,04N_ec_20,20325875,20326301,20325875,426
3464,04N,ec,04N_ec_21,20345018,20345330,20345018,312
3465,04N,ec,04N_ec_22,20551648,20551789,20551648,141
3466,04N,ec,04N_ec_23,20553410,20554280,20554280,870
3467,04N,ec,04N_ec_24,21817068,21817569,21817569,501
3468,04N,ec,04N_ec_25,28866993,28867202,28867202,209
3469,04N,ec,04N_ec_26,33629021,33629994,33629021,973
3470,04N,ec,04N_ec_27,34158937,34167368,34158937,8431
3471,04N,ec,04N_ec_28,34397709,34397710,34397710,1
3472,04N,ec,04N_ec_29,38422250,38422251,38422250,1
3473,04N,ec,04N_ec_30,40498636,40502768,40499012,4132
3474,04N,ec,04N_ec_31,42757479,42758695,42757716,1216
3475,04N,ec,04N_ec_32,42760701,42761445,42760791,744
3476,04N,ec,04N_ec_33,42820328,42820583,42820328,255
3477,04N,ec,04N_ec_34,43115232,43116312,43115232,1080
3478,04N,ec,04N_ec_35,46655568,46659408,46659397,3840
3479,05K,ec,05K_ec_1,1237380,1237747,1237573,367
3480,05K,ec,05K_ec_2,1239511,1239661,1239511,150
3481,05K,ec,05K_ec_3,3231550,3236192,3232199,4642
3482,05K,ec,05K_ec_4,17107804,17108461,17108461,657
3483,05K,ec,05K_ec_5,31358318,31360510,31358318,2192
3484,05K,ec,05K_ec_6,31664153,31665508,31664153,1355
3485,05K,ec,05K_ec_7,31686996,31687008,31686996,12
3486,05K,ec,05K_ec_8,31690210,31697180,31690827,6970
3487,05K,ec,05K_ec_9,31700012,31706554,31706136,6542
3488,05K,ec,05K_ec_10,31707689,31708396,31707889,707
3489,05K,ec,05K_ec_11,31734786,31741892,31740750,7106
3490,05K,ec,05K_ec_12,31742968,31762360,31752188,19392
3491,05K,ec,05K_ec_13,31763758,31766328,31766269,2570
3492,05K,ec,05K_ec_14,31766711,31768608,31766933,1897
3493,05K,ec,05K_ec_15,31769459,31770117,31769704,658
3494,05K,ec,05K_ec_16,31772751,31774730,31773729,1979
3495,05K,ec,05K_ec_17,31777737,31779048,31777737,1311
3496,05K,ec,05K_ec_18,31780862,31802269,31800209,21407
3497,05K,ec,05K_ec_19,31816133,31820587,31817865,4454
3498,05K,ec,05K_ec_20,31822395,31828000,31823463,5605
3499,05K,ec,05K_ec_21,31829156,31845898,31845416,16742
3500,05K,ec,05K_ec_22,31847161,31847290,31847290,129
3501,05K,ec,05K_ec_23,31847737,31854509,31852076,6772
3502,05K,ec,05K_ec_24,31855635,31857275,31857275,1640
3503,05K,ec,05K_ec_25,31858528,31873881,31858895,15353
3504,05K,ec,05K_ec_26,31875752,31896428,31895305,20676
3505,05K,ec,05K_ec_27,31897793,31935572,31900762,37779
3506,05K,ec,05K_ec_28,31948805,31949027,31949027,222
3507,05K,ec,05K_ec_29,31953627,31959619,31954731,5992
3508,05K,ec,05K_ec_30,31961443,31976144,31961443,14701
3509,05K,ec,05K_ec_31,31977706,31977738,31977738,32
3510,05K,ec,05K_ec_32,31991333,32005458,31992159,14125
3511,05K,ec,05K_ec_33,32006121,32027107,32027107,20986
3512,05K,ec,05K_ec_34,32038361,32050388,32046031,12027
3513,05K,ec,05K_ec_35,32052250,32080214,32080068,27964
3514,05K,ec,05K_ec_36,32081029,32081284,32081229,255
3515,05K,ec,05K_ec_37,32084343,32102244,32084343,17901
3516,05K,ec,05K_ec_38,32105535,32111204,32107722,5669
3517,05K,ec,05K_ec_39,32113364,32121375,32113883,8011
3518,05K,ec,05K_ec_40,32124235,32133669,32131160,9434
3519,05K,ec,05K_ec_41,32136653,32138482,32138477,1829
3520,05K,ec,05K_ec_42,32159966,32163088,32160373,3122
3521,05K,ec,05K_ec_43,32164119,32190010,32164119,25891
3522,05K,ec,05K_ec_44,32191905,32202164,32201088,10259
3523,05K,ec,05K_ec_45,32216844,32232138,32232138,15294
3524,05K,ec,05K_ec_46,32269294,32270687,32269294,1393
3525,05K,ec,05K_ec_47,32284425,32291009,32288040,6584
3526,05K,ec,05K_ec_48,32296406,32298492,32296406,2086
3527,05K,ec,05K_ec_49,32309167,32309171,32309171,4
3528,05K,ec,05K_ec_50,32314623,32316466,32315671,1843
3529,05K,ec,05K_ec_51,32353816,32355484,32354838,1668
3530,05K,ec,05K_ec_52,32360555,32362554,32361337,1999
3531,05K,ec,05K_ec_53,32364004,32364386,32364004,382
3532,05K,ec,05K_ec_54,32366404,32369373,32367223,2969
3533,05K,ec,05K_ec_55,32381936,32382070,32382064,134
3534,05K,ec,05K_ec_56,32385835,32393323,32392893,7488
3535,05K,ec,05K_ec_57,32397467,32399060,32398913,1593
3536,05K,ec,05K_ec_58,32402267,32404287,32404287,2020
3537,05K,ec,05K_ec_59,32407625,32408852,32408513,1227
3538,05K,ec,05K_ec_60,32414548,32424891,32415727,10343
3539,05K,ec,05K_ec_61,32457764,32458608,32458608,844
3540,05K,ec,05K_ec_62,32508211,32508486,32508211,275
3541,05K,ec,05K_ec_63,32513265,32522732,32516576,9467
3542,05K,ec,05K_ec_64,32527566,32528110,32528110,544
3543,05K,ec,05K_ec_65,32532617,32534424,32534424,1807
3544,05K,ec,05K_ec_66,32538623,32539422,32539422,799
3545,05K,ec,05K_ec_67,32540409,32545757,32540409,5348
3546,05K,ec,05K_ec_68,32556962,32557259,32556962,297
3547,05K,ec,05K_ec_69,32558257,32558623,32558257,366
3548,05K,ec,05K_ec_70,32559901,32560685,32560685,784
3549,05K,ec,05K_ec_71,32579885,32587634,32579885,7749
3550,05K,ec,05K_ec_72,40161483,40162197,40161483,714
3551,05K,ec,05K_ec_73,40434577,40436018,40435085,1441
3552,05K,ec,05K_ec_74,40454070,40454318,40454070,248
3553,05K,ec,05K_ec_75,40456384,40459043,40458004,2659
3554,05K,ec,05K_ec_76,40470410,40471791,40470601,1381
3555,05K,ec,05K_ec_77,40485331,40485758,40485758,427
3556,05K,ec,05K_ec_78,40492131,40492878,40492878,747
3557,05K,ec,05K_ec_79,40494078,40496779,40494078,2701
3558,05K,ec,05K_ec_80,40528907,40530200,40530187,1293
3559,05K,ec,05K_ec_81,40539563,40544283,40543110,4720
3560,05K,ec,05K_ec_82,40546727,40546782,40546782,55
3561,05K,ec,05K_ec_83,40552411,40557556,40557556,5145
3562,05K,ec,05K_ec_84,40559950,40561703,40559950,1753
3563,05K,ec,05K_ec_85,40608455,40609100,40608455,645
3564,05K,ec,05K_ec_86,40610335,40626778,40611951,16443
3565,05K,ec,05K_ec_87,40635331,40635803,40635803,472
3566,05K,ec,05K_ec_88,40639186,40641736,40641736,2550
3567,05K,ec,05K_ec_89,40643575,40644019,40643575,444
3568,05K,ec,05K_ec_90,40646374,40651187,40648123,4813
3569,05K,ec,05K_ec_91,40652481,40659153,40653328,6672
3570,05K,ec,05K_ec_92,40663476,40667864,40666624,4388
3571,05K,ec,05K_ec_93,40682406,40685651,40684003,3245
3572,05K,ec,05K_ec_94,41185249,41185353,41185353,104
3573,05K,ec,05K_ec_95,42965434,42965485,42965485,51
3574,05K,ec,05K_ec_96,45770837,45770993,45770993,156
3575,05K,ec,05K_ec_97,46713984,46714130,46714130,146
3576,05K,ec,05K_ec_98,51593666,51593920,51593920,254
3577,05K,ec,05K_ec_99,51677818,51678366,51677818,548
3578,05K,ec,05K_ec_100,53661020,53661602,53661063,582
3579,05K,ec,05K_ec_101,54321551,54349291,54348950,27740
3580,05K,ec,05K_ec_102,55049533,55049695,55049533,162
3581,05K,ec,05K_ec_103,57194310,57194319,57194319,9
3582,05K,ec,05K_ec_104,60421266,60421388,60421266,122
3583,05K,ec,05K_ec_105,60422240,60422918,60422918,678
3584,05K,ec,05K_ec_106,60490484,60492118,60492118,1634
3585,05K,ec,05K_ec_107,61335298,61335313,61335298,15
3586,05N,ec,05N_ec_1,5481201,5481562,5481562,361
3587,05N,ec,05N_ec_2,8406130,8406200,8406130,70
3588,05N,ec,05N_ec_3,9678311,9679098,9678339,787
3589,05N,ec,05N_ec_4,9772393,9775584,9773335,3191
3590,05N,ec,05N_ec_5,9776841,9777572,9776841,731
3591,05N,ec,05N_ec_6,9786055,9786578,9786578,523
3592,05N,ec,05N_ec_7,9787249,9787777,9787777,528
3593,05N,ec,05N_ec_8,17916813,17916815,17916815,2
3594,05N,ec,05N_ec_9,22445573,22445817,22445573,244
3595,05N,ec,05N_ec_10,23005540,23005822,23005540,282
3596,05N,ec,05N_ec_11,23571537,23572344,23572344,807
3597,05N,ec,05N_ec_12,23700022,23700239,23700022,217
3598,05N,ec,05N_ec_13,29456676,29456707,29456707,31
3599,05N,ec,05N_ec_14,29460576,29461759,29461759,1183
3600,05N,ec,05N_ec_15,29462577,29463102,29462692,525
3601,05N,ec,05N_ec_16,29482692,29482937,29482740,245
3602,05N,ec,05N_ec_17,33147937,33148078,33147937,141
3603,05N,ec,05N_ec_18,39713144,39713299,39713299,155
3604,05N,ec,05N_ec_19,39714051,39714298,39714051,247
3605,05N,ec,05N_ec_20,39715311,39716918,39716918,1607
3606,05N,ec,05N_ec_21,39719525,39719949,39719525,424
3607,05N,ec,05N_ec_22,39721068,39723975,39721653,2907
3608,05N,ec,05N_ec_23,39724920,39725341,39725182,421
3609,05N,ec,05N_ec_24,39726116,39727112,39726560,996
3610,05N,ec,05N_ec_25,39728302,39729817,39728302,1515
3611,05N,ec,05N_ec_26,39730900,39731023,39731023,123
3612,05N,ec,05N_ec_27,39748046,39751816,39750484,3770
3613,05N,ec,05N_ec_28,39754651,39756442,39756442,1791
3614,05N,ec,05N_ec_29,40343024,40343130,40343024,106
3615,05N,ec,05N_ec_30,40351691,40351796,40351796,105
3616,05N,ec,05N_ec_31,44854975,44855017,44855017,42
3617,05N,ec,05N_ec_32,45439403,45439784,45439784,381
3618,05N,ec,05N_ec_33,48388673,48390607,48389288,1934
3619,05N,ec,05N_ec_34,49361027,49365589,49364285,4562
3620,05N,ec,05N_ec_35,50901870,50901959,50901959,89
3621,05N,ec,05N_ec_36,53683431,53683575,53683575,144
3622,05N,ec,05N_ec_37,57246801,57250616,57247785,3815
3623,05N,ec,05N_ec_38,58426146,58426449,58426146,303
3624,05N,ec,05N_ec_39,58718678,58721346,58721084,2668
3625,05N,ec,05N_ec_40,58722036,58724370,58723047,2334
3626,05N,ec,05N_ec_41,58757574,58759489,58757574,1915
3627,05N,ec,05N_ec_42,58761377,58763382,58763223,2005
3628,05N,ec,05N_ec_43,58833779,58833977,58833779,198
3629,05N,ec,05N_ec_44,63825702,63825823,63825823,121
3630,05N,ec,05N_ec_45,64578058,64579862,64579862,1804
3631,05N,ec,05N_ec_46,64590243,64595720,64595675,5477
3632,05N,ec,05N_ec_47,64597981,64598192,64597981,211
3633,05N,ec,05N_ec_48,64602893,64603907,64603262,1014
3634,05N,ec,05N_ec_49,67401751,67401903,67401751,152
3635,06K,ec,06K_ec_1,1059083,1059952,1059952,869
3636,06K,ec,06K_ec_2,6347723,6347737,6347723,14
3637,06K,ec,06K_ec_3,8585562,8587844,8587542,2282
3638,06K,ec,06K_ec_4,8631040,8631541,8631040,501
3639,06K,ec,06K_ec_5,10090525,10090581,10090581,56
3640,06K,ec,06K_ec_6,10889665,10889852,10889852,187
3641,06K,ec,06K_ec_7,10893283,10893296,10893283,13
3642,06K,ec,06K_ec_8,10895874,10896057,10895874,183
3643,06K,ec,06K_ec_9,10902283,10902312,10902283,29
3644,06K,ec,06K_ec_10,10903151,10906842,10906842,3691
3645,06K,ec,06K_ec_11,10909260,10911613,10910002,2353
3646,06K,ec,06K_ec_12,11239976,11244433,11240632,4457
3647,06K,ec,06K_ec_13,11246468,11246479,11246479,11
3648,06K,ec,06K_ec_14,11253230,11253963,11253963,733
3649,06K,ec,06K_ec_15,11256224,11256427,11256427,203
3650,06K,ec,06K_ec_16,11257157,11257848,11257498,691
3651,06K,ec,06K_ec_17,11262037,11262466,11262037,429
3652,06K,ec,06K_ec_18,11264786,11264868,11264868,82
3653,06K,ec,06K_ec_19,11282751,11289389,11283150,6638
3654,06K,ec,06K_ec_20,11291113,11291124,11291124,11
3655,06K,ec,06K_ec_21,11486395,11498105,11498105,11710
3656,06K,ec,06K_ec_22,12025329,12025402,12025329,73
3657,06K,ec,06K_ec_23,12656279,12664639,12664639,8360
3658,06K,ec,06K_ec_24,16663402,16665341,16663448,1939
3659,06K,ec,06K_ec_25,16667413,16669201,16667835,1788
3660,06K,ec,06K_ec_26,16679823,16679929,16679823,106
3661,06K,ec,06K_ec_27,16682871,16682880,16682871,9
3662,06K,ec,06K_ec_28,17544651,17545333,17544651,682
3663,06K,ec,06K_ec_29,17545824,17548124,17547083,2300
3664,06K,ec,06K_ec_30,17549732,17549968,17549968,236
3665,06K,ec,06K_ec_31,17666569,17673208,17667303,6639
3666,06K,ec,06K_ec_32,25747848,25759951,25748614,12103
3667,06K,ec,06K_ec_33,25762414,25767361,25767361,4947
3668,06K,ec,06K_ec_34,25864939,25865869,25864939,930
3669,06K,ec,06K_ec_35,25867586,25868984,25868853,1398
3670,06K,ec,06K_ec_36,34211584,34213496,34212137,1912
3671,06K,ec,06K_ec_37,36445446,36446338,36445446,892
3672,06K,ec,06K_ec_38,36742164,36742343,36742164,179
3673,06K,ec,06K_ec_39,36914257,36916308,36914999,2051
3674,06K,ec,06K_ec_40,37840200,37841024,37840200,824
3675,06K,ec,06K_ec_41,39669612,39670093,39670093,481
3676,06K,ec,06K_ec_42,40248956,40248958,40248956,2
3677,06K,ec,06K_ec_43,41215936,41216357,41216357,421
3678,06K,ec,06K_ec_44,43633006,43633269,43633269,263
3679,06K,ec,06K_ec_45,44419053,44422260,44419053,3207
3680,06K,ec,06K_ec_46,45896064,45899179,45897196,3115
3681,06K,ec,06K_ec_47,46526854,46529843,46528501,2989
3682,06N,ec,06N_ec_1,1410366,1410977,1410977,611
3683,06N,ec,06N_ec_2,6830827,6831016,6830827,189
3684,06N,ec,06N_ec_3,6945753,6945842,6945753,89
3685,06N,ec,06N_ec_4,8075546,8076525,8076525,979
3686,06N,ec,06N_ec_5,8077416,8077866,8077866,450
3687,06N,ec,06N_ec_6,8081199,8081788,8081199,589
3688,06N,ec,06N_ec_7,8082862,8083280,8082862,418
3689,06N,ec,06N_ec_8,19482702,19482815,19482815,113
3690,06N,ec,06N_ec_9,19767262,19767294,19767262,32
3691,06N,ec,06N_ec_10,20268113,20269061,20268860,948
3692,06N,ec,06N_ec_11,20270317,20271009,20271009,692
3693,06N,ec,06N_ec_12,20319726,20320070,20320070,344
3694,06N,ec,06N_ec_13,20372579,20372845,20372845,266
3695,06N,ec,06N_ec_14,20376793,20377095,20377095,302
3696,06N,ec,06N_ec_15,20377599,20377829,20377806,230
3697,06N,ec,06N_ec_16,20378370,20378414,20378370,44
3698,06N,ec,06N_ec_17,20379184,20381067,20381067,1883
3699,06N,ec,06N_ec_18,20381938,20382532,20382532,594
3700,06N,ec,06N_ec_19,20411054,20411874,20411321,820
3701,06N,ec,06N_ec_20,27046805,27048762,27048633,1957
3702,06N,ec,06N_ec_21,27049918,27052429,27049918,2511
3703,06N,ec,06N_ec_22,27081355,27085209,27083306,3854
3704,06N,ec,06N_ec_23,27089951,27091516,27091516,1565
3705,06N,ec,06N_ec_24,27999265,27999652,27999652,387
3706,06N,ec,06N_ec_25,28659402,28660588,28659402,1186
3707,06N,ec,06N_ec_26,28663589,28664776,28664776,1187
3708,06N,ec,06N_ec_27,28666726,28667010,28666726,284
3709,06N,ec,06N_ec_28,28668613,28668913,28668613,300
3710,06N,ec,06N_ec_29,28675340,28675387,28675387,47
3711,06N,ec,06N_ec_30,28706240,28706428,28706240,188
3712,06N,ec,06N_ec_31,30775760,30776156,30775760,396
3713,06N,ec,06N_ec_32,31995681,31997922,31997922,2241
3714,06N,ec,06N_ec_33,32188126,32188785,32188126,659
3715,06N,ec,06N_ec_34,40842762,40842808,40842808,46
3716,06N,ec,06N_ec_35,40996615,41000529,40998824,3914
3717,06N,ec,06N_ec_36,45593241,45603158,45593241,9917
3718,06N,ec,06N_ec_37,48820301,48826981,48826981,6680
3719,07K,ec,07K_ec_1,1925406,1925418,1925406,12
3720,07K,ec,07K_ec_2,1950095,1956717,1953281,6622
3721,07K,ec,07K_ec_3,1958466,1970856,1960151,12390
3722,07K,ec,07K_ec_4,5563656,5567493,5563739,3837
3723,07K,ec,07K_ec_5,5585043,5586955,5585268,1912
3724,07K,ec,07K_ec_6,5588894,5589192,5589192,298
3725,07K,ec,07K_ec_7,5618427,5621686,5621686,3259
3726,07K,ec,07K_ec_8,5635379,5637801,5636602,2422
3727,07K,ec,07K_ec_9,5639044,5643973,5640783,4929
3728,07K,ec,07K_ec_10,5645775,5646384,5645955,609
3729,07K,ec,07K_ec_11,5660790,5661211,5661211,421
3730,07K,ec,07K_ec_12,5736032,5736189,5736032,157
3731,07K,ec,07K_ec_13,5747412,5747466,5747412,54
3732,07K,ec,07K_ec_14,5759419,5779259,5759419,19840
3733,07K,ec,07K_ec_15,5783239,5786843,5786013,3604
3734,07K,ec,07K_ec_16,5796823,5802911,5800365,6088
3735,07K,ec,07K_ec_17,5803990,5804031,5803990,41
3736,07K,ec,07K_ec_18,5826250,5837706,5836028,11456
3737,07K,ec,07K_ec_19,5838453,5840775,5839563,2322
3738,07K,ec,07K_ec_20,5842483,5842950,5842950,467
3739,07K,ec,07K_ec_21,5845739,5851795,5849274,6056
3740,07K,ec,07K_ec_22,5882370,5882581,5882370,211
3741,07K,ec,07K_ec_23,5913963,5914049,5914049,86
3742,07K,ec,07K_ec_24,6152235,6152376,6152235,141
3743,07K,ec,07K_ec_25,14106632,14107777,14107777,1145
3744,07K,ec,07K_ec_26,20045258,20045471,20045463,213
3745,07K,ec,07K_ec_27,23313035,23313185,23313185,150
3746,07K,ec,07K_ec_28,31550989,31551472,31551472,483
3747,07K,ec,07K_ec_29,34832498,34833882,34833488,1384
3748,07K,ec,07K_ec_30,36072935,36073873,36073873,938
3749,07K,ec,07K_ec_31,41032911,41033093,41032911,182
3750,07K,ec,07K_ec_32,42354995,42355013,42354995,18
3751,07K,ec,07K_ec_33,44906425,44906592,44906592,167
3752,07K,ec,07K_ec_34,47435547,47435587,47435587,40
3753,07K,ec,07K_ec_35,49000351,49000998,49000998,647
3754,07K,ec,07K_ec_36,50218892,50218893,50218892,1
3755,07K,ec,07K_ec_37,50239040,50239075,50239075,35
3756,07K,ec,07K_ec_38,50242805,50242819,50242805,14
3757,07K,ec,07K_ec_39,50352471,50352478,50352478,7
3758,07K,ec,07K_ec_40,50816725,50817396,50817396,671
3759,07N,ec,07N_ec_1,119478,119479,119479,1
3760,07N,ec,07N_ec_2,1861255,1861381,1861255,126
3761,07N,ec,07N_ec_3,2100810,2102268,2100810,1458
3762,07N,ec,07N_ec_4,2455937,2456045,2455937,108
3763,07N,ec,07N_ec_5,6007923,6013443,6013443,5520
3764,07N,ec,07N_ec_6,6481274,6481295,6481274,21
3765,07N,ec,07N_ec_7,15190418,15190924,15190924,506
3766,07N,ec,07N_ec_8,18401139,18401337,18401337,198
3767,07N,ec,07N_ec_9,31818119,31818170,31818119,51
3768,07N,ec,07N_ec_10,39637832,39640823,39640021,2991
3769,07N,ec,07N_ec_11,40133955,40135450,40133955,1495
3770,07N,ec,07N_ec_12,40209640,40209720,40209640,80
3771,07N,ec,07N_ec_13,41026405,41027058,41026919,653
3772,07N,ec,07N_ec_14,41040745,41040870,41040745,125
3773,07N,ec,07N_ec_15,43058489,43060000,43058489,1511
3774,07N,ec,07N_ec_16,44244561,44244580,44244561,19
3775,07N,ec,07N_ec_17,44480479,44480921,44480921,442
3776,07N,ec,07N_ec_18,45322472,45326753,45322472,4281
3777,07N,ec,07N_ec_19,48856073,48856623,48856623,550
3778,07N,ec,07N_ec_20,48862032,48862630,48862630,598
3779,07N,ec,07N_ec_21,48953779,48957556,48955859,3777
3780,08K,ec,08K_ec_1,2406571,2407662,2407636,1091
3781,08K,ec,08K_ec_2,3827477,3827520,3827477,43
3782,08K,ec,08K_ec_3,8212661,8212791,8212791,130
3783,08K,ec,08K_ec_4,9887623,9887673,9887666,50
3784,08K,ec,08K_ec_5,12610070,12621932,12620803,11862
3785,08K,ec,08K_ec_6,12626153,12626804,12626163,651
3786,08K,ec,08K_ec_7,12640422,12640877,12640478,455
3787,08K,ec,08K_ec_8,25435275,25439001,25437126,3726
3788,08K,ec,08K_ec_9,25440058,25441498,25441498,1440
3789,08K,ec,08K_ec_10,25448213,25451720,25451166,3507
3790,08K,ec,08K_ec_11,25452691,25462944,25461866,10253
3791,08K,ec,08K_ec_12,25478807,25479453,25478807,646
3792,08K,ec,08K_ec_13,25507764,25511002,25509391,3238
3793,08K,ec,08K_ec_14,28390318,28390474,28390318,156
3794,08K,ec,08K_ec_15,32892284,32892554,32892284,270
3795,08K,ec,08K_ec_16,44529834,44530105,44530105,271
3796,08K,ec,08K_ec_17,48552055,48552539,48552539,484
3797,08N,ec,08N_ec_1,1664210,1667364,1664562,3154
3798,08N,ec,08N_ec_2,1670849,1671848,1671015,999
3799,08N,ec,08N_ec_3,3166758,3166823,3166758,65
3800,08N,ec,08N_ec_4,5590654,5590768,5590768,114
3801,08N,ec,08N_ec_5,9954530,9954634,9954530,104
3802,08N,ec,08N_ec_6,9956966,9957277,9956966,311
3803,08N,ec,08N_ec_7,22626009,22626477,22626476,468
3804,08N,ec,08N_ec_8,22962489,22964586,22963820,2097
3805,08N,ec,08N_ec_9,22976627,22976854,22976627,227
3806,08N,ec,08N_ec_10,22979067,22979159,22979067,92
3807,08N,ec,08N_ec_11,22981224,22981311,22981311,87
3808,08N,ec,08N_ec_12,23184184,23184217,23184217,33
3809,08N,ec,08N_ec_13,23231038,23231107,23231038,69
3810,08N,ec,08N_ec_14,23232503,23232862,23232862,359
3811,08N,ec,08N_ec_15,23363396,23363836,23363836,440
3812,08N,ec,08N_ec_16,23390629,23391179,23390717,550
3813,08N,ec,08N_ec_17,24096655,24097065,24096730,410
3814,08N,ec,08N_ec_18,24099074,24099622,24099622,548
3815,08N,ec,08N_ec_19,24283127,24283693,24283693,566
3816,08N,ec,08N_ec_20,24284602,24285332,24284651,730
3817,08N,ec,08N_ec_21,24306389,24306968,24306601,579
3818,08N,ec,08N_ec_22,24358492,24358831,24358492,339
3819,08N,ec,08N_ec_23,24361870,24362276,24362276,406
3820,08N,ec,08N_ec_24,24369448,24373387,24369448,3939
3821,08N,ec,08N_ec_25,24375558,24383053,24383053,7495
3822,08N,ec,08N_ec_26,24385235,24385602,24385602,367
3823,08N,ec,08N_ec_27,24393190,24393441,24393441,251
3824,08N,ec,08N_ec_28,24399085,24400243,24399106,1158
3825,08N,ec,08N_ec_29,24404502,24405417,24404691,915
3826,08N,ec,08N_ec_30,24419181,24419203,24419203,22
3827,08N,ec,08N_ec_31,24435397,24437027,24436914,1630
3828,08N,ec,08N_ec_32,24441631,24441662,24441631,31
3829,08N,ec,08N_ec_33,24448550,24461050,24448550,12500
3830,08N,ec,08N_ec_34,24462500,24462923,24462500,423
3831,08N,ec,08N_ec_35,24558599,24558649,24558649,50
3832,08N,ec,08N_ec_36,24563642,24565951,24564109,2309
3833,08N,ec,08N_ec_37,24568272,24569741,24569206,1469
3834,08N,ec,08N_ec_38,24574605,24575457,24575457,852
3835,08N,ec,08N_ec_39,24612347,24612415,24612347,68
3836,08N,ec,08N_ec_40,24615853,24632349,24617335,16496
3837,08N,ec,08N_ec_41,24643325,24646012,24645980,2687
3838,08N,ec,08N_ec_42,24818085,24819542,24818593,1457
3839,08N,ec,08N_ec_43,24821800,24823039,24823039,1239
3840,08N,ec,08N_ec_44,24825144,24825492,24825288,348
3841,08N,ec,08N_ec_45,24827439,24833420,24827439,5981
3842,08N,ec,08N_ec_46,24836832,24836986,24836832,154
3843,08N,ec,08N_ec_47,24838708,24839918,24838708,1210
3844,08N,ec,08N_ec_48,24842950,24847444,24847013,4494
3845,08N,ec,08N_ec_49,24852065,24858027,24855926,5962
3846,08N,ec,08N_ec_50,24862613,24864924,24863564,2311
3847,08N,ec,08N_ec_51,24865763,24866482,24866338,719
3848,08N,ec,08N_ec_52,24868130,24872177,24871731,4047
3849,08N,ec,08N_ec_53,24874613,24875322,24874613,709
3850,08N,ec,08N_ec_54,24876680,24878367,24878367,1687
3851,08N,ec,08N_ec_55,24888545,24889248,24888545,703
3852,08N,ec,08N_ec_56,24890367,24892135,24890888,1768
3853,08N,ec,08N_ec_57,24893115,24904562,24896158,11447
3854,08N,ec,08N_ec_58,24908022,24922163,24922163,14141
3855,08N,ec,08N_ec_59,24923451,24923528,24923451,77
3856,08N,ec,08N_ec_60,24937108,24937295,24937108,187
3857,08N,ec,08N_ec_61,24937846,24939510,24938165,1664
3858,08N,ec,08N_ec_62,24941294,24941850,24941778,556
3859,08N,ec,08N_ec_63,24943624,24943798,24943624,174
3860,08N,ec,08N_ec_64,24946156,24946559,24946559,403
3861,08N,ec,08N_ec_65,24948810,24951995,24950291,3185
3862,08N,ec,08N_ec_66,25799210,25799839,25799839,629
3863,08N,ec,08N_ec_67,32563655,32563706,32563655,51
3864,08N,ec,08N_ec_68,43484868,43484908,43484908,40
3865,09K,ec,09K_ec_1,3619973,3620249,3620249,276
3866,09K,ec,09K_ec_2,4288797,4290498,4288902,1701
3867,09K,ec,09K_ec_3,4291307,4292004,4291307,697
3868,09K,ec,09K_ec_4,4292700,4293094,4293094,394
3869,09K,ec,09K_ec_5,5104458,5106530,5104458,2072
3870,09K,ec,09K_ec_6,5750578,5750688,5750578,110
3871,09K,ec,09K_ec_7,6166197,6166277,6166277,80
3872,09K,ec,09K_ec_8,6409244,6409354,6409244,110
3873,09K,ec,09K_ec_9,9170589,9173550,9173459,2961
3874,09K,ec,09K_ec_10,10548003,10564653,10558769,16650
3875,09K,ec,09K_ec_11,10581356,10581692,10581356,336
3876,09K,ec,09K_ec_12,12451099,12453690,12451099,2591
3877,09K,ec,09K_ec_13,12461052,12461465,12461052,413
3878,09K,ec,09K_ec_14,13616430,13616628,13616470,198
3879,09K,ec,09K_ec_15,13744390,13744642,13744390,252
3880,09K,ec,09K_ec_16,17382138,17382224,17382224,86
3881,09K,ec,09K_ec_17,18375169,18377389,18377288,2220
3882,09K,ec,09K_ec_18,21180987,21181498,21181042,511
3883,09K,ec,09K_ec_19,22063736,22064114,22063736,378
3884,09K,ec,09K_ec_20,22065102,22066788,22065143,1686
3885,09K,ec,09K_ec_21,22563627,22563792,22563792,165
3886,09K,ec,09K_ec_22,22999994,23005956,23005816,5962
3887,09K,ec,09K_ec_23,25428029,25428145,25428145,116
3888,09K,ec,09K_ec_24,25454414,25454642,25454414,228
3889,09K,ec,09K_ec_25,27929515,27929554,27929515,39
3890,09K,ec,09K_ec_26,28884336,28884623,28884336,287
3891,09K,ec,09K_ec_27,31288168,31288278,31288278,110
3892,09K,ec,09K_ec_28,31292052,31292247,31292052,195
3893,09K,ec,09K_ec_29,31295045,31295840,31295045,795
3894,09K,ec,09K_ec_30,32031037,32031334,32031037,297
3895,09K,ec,09K_ec_31,35494042,35494359,35494042,317
3896,09K,ec,09K_ec_32,35570980,35571011,35570980,31
3897,09K,ec,09K_ec_33,37684113,37684451,37684113,338
3898,09K,ec,09K_ec_34,38782694,38782838,38782694,144
3899,09K,ec,09K_ec_35,42015663,42021830,42016853,6167
3900,09K,ec,09K_ec_36,43726769,43726790,43726769,21
3901,09K,ec,09K_ec_37,46919743,46919922,46919922,179
3902,09K,ec,09K_ec_38,47331011,47331548,47331548,537
3903,09K,ec,09K_ec_39,47345229,47345266,47345266,37
3904,09K,ec,09K_ec_40,50614234,50614777,50614235,543
3905,09K,ec,09K_ec_41,51454035,51454275,51454275,240
3906,09K,ec,09K_ec_42,52871587,52873308,52873288,1721
3907,09K,ec,09K_ec_43,54740157,54740483,54740483,326
3908,09K,ec,09K_ec_44,54741029,54745822,54741586,4793
3909,09K,ec,09K_ec_45,54747913,54749163,54749163,1250
3910,09K,ec,09K_ec_46,54750010,54750094,54750010,84
3911,09K,ec,09K_ec_47,56086483,56089928,56086483,3445
3912,09K,ec,09K_ec_48,56192841,56196266,56194902,3425
3913,09K,ec,09K_ec_49,56232062,56246500,56237842,14438
3914,09K,ec,09K_ec_50,56248169,56259756,56259023,11587
3915,09K,ec,09K_ec_51,56260653,56261530,56260722,877
3916,09K,ec,09K_ec_52,56263661,56264906,56264239,1245
3917,09K,ec,09K_ec_53,57024214,57025450,57025450,1236
3918,09K,ec,09K_ec_54,57403065,57403308,57403065,243
3919,09K,ec,09K_ec_55,57462453,57463308,57462453,855
3920,09K,ec,09K_ec_56,58273151,58274656,58274656,1505
3921,09K,ec,09K_ec_57,58278869,58280831,58278869,1962
3922,09K,ec,09K_ec_58,58283967,58285967,58285967,2000
3923,09K,ec,09K_ec_59,60224419,60225450,60224419,1031
3924,09K,ec,09K_ec_60,60245488,60245489,60245488,1
3925,09K,ec,09K_ec_61,66072159,66072481,66072159,322
3926,09K,ec,09K_ec_62,67098310,67098343,67098310,33
3927,09K,ec,09K_ec_63,67100564,67102059,67100710,1495
3928,09K,ec,09K_ec_64,69344701,69348561,69347911,3860
3929,09K,ec,09K_ec_65,69774985,69775345,69774985,360
3930,09K,ec,09K_ec_66,69784850,69787132,69784850,2282
3931,09N,ec,09N_ec_1,113863,125471,113871,11608
3932,09N,ec,09N_ec_2,126889,128743,128726,1854
3933,09N,ec,09N_ec_3,165177,165695,165177,518
3934,09N,ec,09N_ec_4,166790,167295,166798,505
3935,09N,ec,09N_ec_5,176363,176732,176363,369
3936,09N,ec,09N_ec_6,200543,201224,201224,681
3937,09N,ec,09N_ec_7,255821,259041,258475,3220
3938,09N,ec,09N_ec_8,266163,277420,277296,11257
3939,09N,ec,09N_ec_9,279389,279471,279471,82
3940,09N,ec,09N_ec_10,280090,288375,280090,8285
3941,09N,ec,09N_ec_11,299982,302150,300987,2168
3942,09N,ec,09N_ec_12,303265,308882,305528,5617
3943,09N,ec,09N_ec_13,491608,496276,491608,4668
3944,09N,ec,09N_ec_14,499017,499161,499017,144
3945,09N,ec,09N_ec_15,513378,513684,513378,306
3946,09N,ec,09N_ec_16,565910,565968,565968,58
3947,09N,ec,09N_ec_17,1132401,1132653,1132401,252
3948,09N,ec,09N_ec_18,5321230,5330461,5321230,9231
3949,09N,ec,09N_ec_19,5341033,5341324,5341033,291
3950,09N,ec,09N_ec_20,7365451,7366464,7365451,1013
3951,09N,ec,09N_ec_21,7622354,7625166,7625166,2812
3952,09N,ec,09N_ec_22,8981899,8987374,8986975,5475
3953,09N,ec,09N_ec_23,10031923,10032319,10032047,396
3954,09N,ec,09N_ec_24,10033586,10044555,10044134,10969
3955,09N,ec,09N_ec_25,11460168,11460750,11460750,582
3956,09N,ec,09N_ec_26,11462055,11462413,11462162,358
3957,09N,ec,09N_ec_27,11965464,11965601,11965601,137
3958,09N,ec,09N_ec_28,11969148,11970362,11969148,1214
3959,09N,ec,09N_ec_29,13463440,13463497,13463440,57
3960,09N,ec,09N_ec_30,13465408,13465614,13465408,206
3961,09N,ec,09N_ec_31,13480434,13480614,13480434,180
3962,09N,ec,09N_ec_32,13481701,13481782,13481701,81
3963,09N,ec,09N_ec_33,13483163,13483579,13483579,416
3964,09N,ec,09N_ec_34,13592671,13595296,13594261,2625
3965,09N,ec,09N_ec_35,15008119,15008463,15008346,344
3966,09N,ec,09N_ec_36,16810854,16810856,16810854,2
3967,09N,ec,09N_ec_37,16898920,16899879,16899736,959
3968,09N,ec,09N_ec_38,16902367,16904139,16902395,1772
3969,09N,ec,09N_ec_39,18514457,18514703,18514703,246
3970,09N,ec,09N_ec_40,18655232,18663872,18655232,8640
3971,09N,ec,09N_ec_41,20538474,20539644,20538858,1170
3972,09N,ec,09N_ec_42,21949701,21950517,21950517,816
3973,09N,ec,09N_ec_43,21955626,21957308,21957308,1682
3974,09N,ec,09N_ec_44,21958341,21959308,21958341,967
3975,09N,ec,09N_ec_45,24451397,24452696,24451397,1299
3976,09N,ec,09N_ec_46,24453846,24453905,24453905,59
3977,09N,ec,09N_ec_47,32038984,32040846,32038984,1862
3978,09N,ec,09N_ec_48,32045669,32046023,32045669,354
3979,09N,ec,09N_ec_49,32133201,32133261,32133201,60
3980,09N,ec,09N_ec_50,32290267,32290360,32290267,93
3981,09N,ec,09N_ec_51,32391001,32391415,32391001,414
3982,09N,ec,09N_ec_52,35226662,35226708,35226708,46
3983,09N,ec,09N_ec_53,37072543,37072748,37072748,205
3984,09N,ec,09N_ec_54,37119953,37120196,37119953,243
3985,09N,ec,09N_ec_55,40713961,40714059,40713980,98
3986,09N,ec,09N_ec_56,42506899,42507110,42507110,211
3987,09N,ec,09N_ec_57,42632452,42632685,42632452,233
3988,09N,ec,09N_ec_58,48184514,48185088,48184514,574
3989,09N,ec,09N_ec_59,49714811,49716611,49715579,1800
3990,09N,ec,09N_ec_60,49884951,49885774,49885774,823
3991,09N,ec,09N_ec_61,49897169,49897804,49897687,635
3992,09N,ec,09N_ec_62,49898783,49899582,49899582,799
3993,09N,ec,09N_ec_63,49903401,49903549,49903401,148
3994,09N,ec,09N_ec_64,50306643,50307225,50306643,582
3995,09N,ec,09N_ec_65,55140310,55144417,55142088,4107
3996,09N,ec,09N_ec_66,55145441,55146314,55146314,873
3997,09N,ec,09N_ec_67,55147626,55148168,55147789,542
3998,09N,ec,09N_ec_68,55187764,55188507,55188507,743
3999,09N,ec,09N_ec_69,55189193,55189703,55189193,510
4000,09N,ec,09N_ec_70,55191202,55191597,55191302,395
4001,09N,ec,09N_ec_71,55192785,55192863,55192863,78
4002,09N,ec,09N_ec_72,58719841,58720740,58720736,899
4003,09N,ec,09N_ec_73,59859997,59860429,59859997,432
4004,09N,ec,09N_ec_74,61250553,61255643,61255489,5090
4005,09N,ec,09N_ec_75,61872608,61872793,61872719,185
4006,09N,ec,09N_ec_76,61874430,61874582,61874430,152
4007,09N,ec,09N_ec_77,61880193,61882039,61881464,1846
4008,09N,ec,09N_ec_78,63052608,63052702,63052702,94
4009,09N,ec,09N_ec_79,63426702,63426705,63426705,3
4010,09N,ec,09N_ec_80,67485230,67485287,67485287,57
4011,09N,ec,09N_ec_81,68712330,68714168,68714168,1838
4012,09N,ec,09N_ec_82,68782994,68783090,68782994,96
4013,09N,ec,09N_ec_83,69241184,69244040,69244040,2856
4014,09N,ec,09N_ec_84,69981226,69991447,69991447,10221
4015,09N,ec,09N_ec_85,70597944,70608101,70597944,10157
4016,09N,ec,09N_ec_86,72365069,72365704,72365608,635
4017,09N,ec,09N_ec_87,72645507,72648961,72648398,3454
4018,09N,ec,09N_ec_88,72714486,72715683,72714486,1197
4019,09N,ec,09N_ec_89,73006841,73007616,73007616,775
4020,09N,ec,09N_ec_90,73213690,73279837,73277315,66147
4021,09N,ec,09N_ec_91,73289239,73290045,73289239,806
4022,09N,ec,09N_ec_92,75490819,75493988,75490819,3169
4023,09N,ec,09N_ec_93,76167710,76167893,76167710,183
4024,09N,ec,09N_ec_94,76217221,76217363,76217363,142
4025,09N,ec,09N_ec_95,76764652,76764890,76764652,238
4026,09N,ec,09N_ec_96,77602288,77602492,77602288,204
4027,09N,ec,09N_ec_97,77746528,77746772,77746756,244
4028,09N,ec,09N_ec_98,79300379,79301972,79301588,1593
4029,09N,ec,09N_ec_99,81856540,81866988,81856540,10448
4030,09N,ec,09N_ec_100,82571533,82571852,82571596,319
4031,09N,ec,09N_ec_101,82573597,82574685,82574685,1088
4032,09N,ec,09N_ec_102,82578033,82580810,82578033,2777
4033,09N,ec,09N_ec_103,82591190,82591408,82591190,218
4034,09N,ec,09N_ec_104,82599980,82600967,82599980,987
4035,09N,ec,09N_ec_105,82759963,82760311,82759963,348
4036,09N,ec,09N_ec_106,82767742,82767822,82767822,80
4037,09N,ec,09N_ec_107,82768812,82769083,82769083,271
4038,09N,ec,09N_ec_108,82769818,82770180,82769869,362
4039,09N,ec,09N_ec_109,82776841,82779003,82778807,2162
4040,01K,tx,01K_tx_1,11081448,11081460,11081460,12
4041,01N,tx,01N_tx_1,5921986,5922044,5921986,58
4042,01N,tx,01N_tx_2,8767914,8768012,8767971,98
4043,02K,tx,02K_tx_1,4075972,4076202,4076053,230
4044,02K,tx,02K_tx_2,4090731,4090811,4090811,80
4045,02K,tx,02K_tx_3,25867026,25867164,25867164,138
4046,02K,tx,02K_tx_4,26113130,26116493,26115135,3363
4047,02K,tx,02K_tx_5,28311718,28313071,28312718,1353
4048,02K,tx,02K_tx_6,31151502,31151520,31151520,18
4049,02K,tx,02K_tx_7,31695192,31695917,31695917,725
4050,02K,tx,02K_tx_8,36557054,36557080,36557080,26
4051,02K,tx,02K_tx_9,37571663,37571700,37571700,37
4052,02K,tx,02K_tx_10,50721345,50722917,50722917,1572
4053,02K,tx,02K_tx_11,51654641,51655087,51654641,446
4054,02K,tx,02K_tx_12,54171039,54171127,54171039,88
4055,03K,tx,03K_tx_1,23405078,23407538,23405524,2460
4056,03K,tx,03K_tx_2,24304272,24304335,24304272,63
4057,03K,tx,03K_tx_3,36549357,36563747,36561432,14390
4058,03K,tx,03K_tx_4,36571531,36573911,36572789,2380
4059,03K,tx,03K_tx_5,36578613,36583588,36578613,4975
4060,03K,tx,03K_tx_6,36595045,36595462,36595462,417
4061,03K,tx,03K_tx_7,36605795,36605972,36605852,177
4062,03K,tx,03K_tx_8,36607335,36609284,36608523,1949
4063,03K,tx,03K_tx_9,36610506,36611218,36610566,712
4064,03K,tx,03K_tx_10,36617727,36620497,36619107,2770
4065,03K,tx,03K_tx_11,36621205,36626386,36622632,5181
4066,03K,tx,03K_tx_12,36635373,36637734,36637734,2361
4067,03K,tx,03K_tx_13,36643439,36646187,36646125,2748
4068,03K,tx,03K_tx_14,36761185,36762673,36762673,1488
4069,03K,tx,03K_tx_15,37094887,37096279,37095959,1392
4070,03K,tx,03K_tx_16,37097261,37102867,37100788,5606
4071,03K,tx,03K_tx_17,37114792,37115239,37114792,447
4072,03K,tx,03K_tx_18,37136348,37136800,37136800,452
4073,03K,tx,03K_tx_19,37138010,37138789,37138789,779
4074,03K,tx,03K_tx_20,37172655,37172866,37172866,211
4075,03K,tx,03K_tx_21,37208602,37209156,37209156,554
4076,03K,tx,03K_tx_22,37333553,37334332,37334056,779
4077,03K,tx,03K_tx_23,37338879,37340317,37338879,1438
4078,03K,tx,03K_tx_24,37452485,37452742,37452485,257
4079,03K,tx,03K_tx_25,37518010,37523058,37518010,5048
4080,03K,tx,03K_tx_26,43839149,43839267,43839267,118
4081,03N,tx,03N_tx_1,37853808,37854695,37853808,887
4082,04K,tx,04K_tx_1,24080699,24080806,24080806,107
4083,04K,tx,04K_tx_2,38371644,38371711,38371711,67
4084,04K,tx,04K_tx_3,38376526,38376831,38376831,305
4085,04K,tx,04K_tx_4,46466645,46466952,46466645,307
4086,05N,tx,05N_tx_1,49423547,49425848,49425694,2301
4087,05N,tx,05N_tx_2,55623079,55623416,55623416,337
4088,05N,tx,05N_tx_3,69123669,69123959,69123669,290
4089,05N,tx,05N_tx_4,69124982,69126485,69125345,1503
4090,06K,tx,06K_tx_1,8511671,8511673,8511673,2
4091,06K,tx,06K_tx_2,8512524,8513318,8512524,794
4092,06K,tx,06K_tx_3,19337639,19337678,19337639,39
4093,06K,tx,06K_tx_4,19339870,19343603,19341578,3733
4094,06K,tx,06K_tx_5,19354202,19354320,19354202,118
4095,06K,tx,06K_tx_6,19354878,19356005,19355424,1127
4096,06K,tx,06K_tx_7,19356440,19356819,19356819,379
4097,06K,tx,06K_tx_8,19357951,19361212,19361212,3261
4098,06K,tx,06K_tx_9,19361668,19365501,19363354,3833
4099,06K,tx,06K_tx_10,32510750,32510792,32510792,42
4100,06K,tx,06K_tx_11,32512713,32512831,32512713,118
4101,06K,tx,06K_tx_12,32513304,32513458,32513304,154
4102,06K,tx,06K_tx_13,32515382,32515877,32515382,495
4103,06K,tx,06K_tx_14,32516678,32517384,32517384,706
4104,06N,tx,06N_tx_1,1630882,1633568,1633568,2686
4105,06N,tx,06N_tx_2,15517569,15517857,15517857,288
4106,06N,tx,06N_tx_3,15520975,15521016,15520975,41
4107,06N,tx,06N_tx_4,21743024,21743295,21743295,271
4108,06N,tx,06N_tx_5,21763494,21763539,21763494,45
4109,06N,tx,06N_tx_6,21774067,21774440,21774440,373
4110,06N,tx,06N_tx_7,21792455,21793003,21792523,548
4111,06N,tx,06N_tx_8,21794059,21794476,21794476,417
4112,06N,tx,06N_tx_9,21794971,21795022,21794971,51
4113,06N,tx,06N_tx_10,21802840,21804020,21803380,1180
4114,06N,tx,06N_tx_11,21805177,21806329,21806329,1152
4115,06N,tx,06N_tx_12,21821276,21823203,21821657,1927
4116,06N,tx,06N_tx_13,21824691,21824857,21824857,166
4117,06N,tx,06N_tx_14,21830386,21830865,21830865,479
4118,06N,tx,06N_tx_15,21833752,21834069,21833752,317
4119,06N,tx,06N_tx_16,22181115,22181948,22181115,833
4120,06N,tx,06N_tx_17,22192882,22193986,22193600,1104
4121,06N,tx,06N_tx_18,22199358,22199843,22199842,485
4122,06N,tx,06N_tx_19,22237016,22237104,22237016,88
4123,06N,tx,06N_tx_20,22247703,22249903,22247703,2200
4124,06N,tx,06N_tx_21,22268951,22269394,22269106,443
4125,06N,tx,06N_tx_22,22342794,22344479,22342912,1685
4126,06N,tx,06N_tx_23,22346789,22346831,22346789,42
4127,06N,tx,06N_tx_24,22357892,22358176,22357892,284
4128,06N,tx,06N_tx_25,22359159,22363221,22360642,4062
4129,06N,tx,06N_tx_26,22364495,22364763,22364495,268
4130,06N,tx,06N_tx_27,22378235,22379449,22379449,1214
4131,06N,tx,06N_tx_28,22381699,22381939,22381939,240
4132,06N,tx,06N_tx_29,22410934,22411119,22410934,185
4133,06N,tx,06N_tx_30,22420238,22420319,22420319,81
4134,06N,tx,06N_tx_31,22429079,22430863,22430198,1784
4135,06N,tx,06N_tx_32,22431904,22432058,22432058,154
4136,06N,tx,06N_tx_33,22442638,22443963,22442638,1325
4137,06N,tx,06N_tx_34,22449433,22449740,22449740,307
4138,06N,tx,06N_tx_35,22454681,22454809,22454681,128
4139,06N,tx,06N_tx_36,22461894,22463024,22463024,1130
4140,06N,tx,06N_tx_37,22470331,22472471,22471288,2140
4141,06N,tx,06N_tx_38,22483666,22484015,22484015,349
4142,06N,tx,06N_tx_39,22485043,22485165,22485105,122
4143,06N,tx,06N_tx_40,22490952,22491058,22491058,106
4144,06N,tx,06N_tx_41,22494459,22495126,22494459,667
4145,06N,tx,06N_tx_42,22501696,22501834,22501696,138
4146,06N,tx,06N_tx_43,22505498,22506112,22505498,614
4147,06N,tx,06N_tx_44,22518238,22529958,22529958,11720
4148,06N,tx,06N_tx_45,22531737,22533771,22532938,2034
4149,06N,tx,06N_tx_46,22538580,22539152,22539152,572
4150,06N,tx,06N_tx_47,22543565,22543916,22543916,351
4151,06N,tx,06N_tx_48,22557768,22558926,22558926,1158
4152,06N,tx,06N_tx_49,22569537,22574271,22569537,4734
4153,06N,tx,06N_tx_50,22578926,22582268,22581788,3342
4154,06N,tx,06N_tx_51,22585041,22585597,22585041,556
4155,06N,tx,06N_tx_52,22593340,22594559,22594559,1219
4156,06N,tx,06N_tx_53,22597943,22599696,22599696,1753
4157,06N,tx,06N_tx_54,22604328,22607730,22607730,3402
4158,06N,tx,06N_tx_55,22609268,22609351,22609268,83
4159,06N,tx,06N_tx_56,22626760,22629833,22628955,3073
4160,06N,tx,06N_tx_57,22647305,22650788,22649621,3483
4161,06N,tx,06N_tx_58,22672595,22674134,22673146,1539
4162,06N,tx,06N_tx_59,22679160,22679879,22679879,719
4163,06N,tx,06N_tx_60,22681872,22683608,22682215,1736
4164,06N,tx,06N_tx_61,22718119,22721974,22718780,3855
4165,06N,tx,06N_tx_62,22746915,22748974,22746915,2059
4166,06N,tx,06N_tx_63,22755469,22757159,22755469,1690
4167,06N,tx,06N_tx_64,22759050,22760156,22759373,1106
4168,06N,tx,06N_tx_65,22806686,22809849,22809550,3163
4169,06N,tx,06N_tx_66,22821442,22822072,22822042,630
4170,06N,tx,06N_tx_67,22823046,22823535,22823535,489
4171,06N,tx,06N_tx_68,22824410,22825313,22824963,903
4172,06N,tx,06N_tx_69,22827778,22833100,22827778,5322
4173,06N,tx,06N_tx_70,22838495,22838988,22838495,493
4174,06N,tx,06N_tx_71,22842516,22842562,22842562,46
4175,06N,tx,06N_tx_72,22847045,22847525,22847045,480
4176,06N,tx,06N_tx_73,22848210,22848368,22848367,158
4177,06N,tx,06N_tx_74,22853052,22853582,22853582,530
4178,06N,tx,06N_tx_75,22854682,22854771,22854682,89
4179,06N,tx,06N_tx_76,22856732,22857123,22857123,391
4180,06N,tx,06N_tx_77,22859445,22860674,22859445,1229
4181,06N,tx,06N_tx_78,22909308,22910310,22909915,1002
4182,06N,tx,06N_tx_79,22915001,22915571,22915571,570
4183,06N,tx,06N_tx_80,22916894,22917371,22916956,477
4184,06N,tx,06N_tx_81,22969235,22969549,22969235,314
4185,06N,tx,06N_tx_82,22974152,22975059,22974152,907
4186,06N,tx,06N_tx_83,22976392,22976983,22976983,591
4187,06N,tx,06N_tx_84,22992547,22994810,22994810,2263
4188,06N,tx,06N_tx_85,23002896,23003130,23002896,234
4189,06N,tx,06N_tx_86,23004823,23006871,23006105,2048
4190,06N,tx,06N_tx_87,23011993,23014042,23012765,2049
4191,06N,tx,06N_tx_88,23014929,23015474,23015474,545
4192,06N,tx,06N_tx_89,23021336,23023237,23023237,1901
4193,06N,tx,06N_tx_90,23031478,23032557,23031478,1079
4194,06N,tx,06N_tx_91,23038118,23038316,23038118,198
4195,06N,tx,06N_tx_92,23050590,23052030,23052013,1440
4196,06N,tx,06N_tx_93,23064103,23064957,23064957,854
4197,06N,tx,06N_tx_94,23065777,23067005,23067005,1228
4198,06N,tx,06N_tx_95,23098589,23099259,23099259,670
4199,06N,tx,06N_tx_96,23157164,23157271,23157173,107
4200,06N,tx,06N_tx_97,23158821,23159106,23158821,285
4201,06N,tx,06N_tx_98,23162214,23162948,23162948,734
4202,06N,tx,06N_tx_99,23164530,23164714,23164714,184
4203,06N,tx,06N_tx_100,23165997,23166783,23166431,786
4204,06N,tx,06N_tx_101,23175252,23175298,23175252,46
4205,06N,tx,06N_tx_102,23182795,23183293,23183167,498
4206,06N,tx,06N_tx_103,23184698,23184937,23184698,239
4207,06N,tx,06N_tx_104,23187076,23191279,23187076,4203
4208,06N,tx,06N_tx_105,23192210,23192892,23192892,682
4209,06N,tx,06N_tx_106,23194018,23195347,23194708,1329
4210,06N,tx,06N_tx_107,23264823,23274800,23265362,9977
4211,06N,tx,06N_tx_108,23279778,23280146,23279778,368
4212,06N,tx,06N_tx_109,23296138,23296198,23296138,60
4213,06N,tx,06N_tx_110,23300231,23300837,23300231,606
4214,06N,tx,06N_tx_111,23305161,23305713,23305161,552
4215,06N,tx,06N_tx_112,23307126,23308242,23307894,1116
4216,06N,tx,06N_tx_113,23322896,23322907,23322896,11
4217,06N,tx,06N_tx_114,23340825,23340888,23340825,63
4218,06N,tx,06N_tx_115,23348341,23348407,23348341,66
4219,06N,tx,06N_tx_116,24082416,24082482,24082416,66
4220,06N,tx,06N_tx_117,24171075,24171904,24171075,829
4221,06N,tx,06N_tx_118,24190701,24190883,24190701,182
4222,06N,tx,06N_tx_119,24192010,24192253,24192171,243
4223,06N,tx,06N_tx_120,24194437,24194622,24194622,185
4224,06N,tx,06N_tx_121,24195366,24196007,24196007,641
4225,06N,tx,06N_tx_122,24200635,24201444,24201444,809
4226,06N,tx,06N_tx_123,24206288,24206389,24206288,101
4227,06N,tx,06N_tx_124,24213349,24213508,24213508,159
4228,06N,tx,06N_tx_125,24216556,24217346,24216556,790
4229,06N,tx,06N_tx_126,24221129,24221548,24221129,419
4230,06N,tx,06N_tx_127,24223637,24223822,24223637,185
4231,06N,tx,06N_tx_128,24238316,24238490,24238316,174
4232,06N,tx,06N_tx_129,24242465,24242734,24242505,269
4233,06N,tx,06N_tx_130,24252123,24255426,24252444,3303
4234,06N,tx,06N_tx_131,24258468,24258960,24258468,492
4235,06N,tx,06N_tx_132,24284570,24285206,24285117,636
4236,06N,tx,06N_tx_133,24287762,24287807,24287807,45
4237,06N,tx,06N_tx_134,24288656,24289331,24289176,675
4238,06N,tx,06N_tx_135,24331953,24332057,24331953,104
4239,06N,tx,06N_tx_136,24335086,24335223,24335086,137
4240,06N,tx,06N_tx_137,24336338,24336579,24336579,241
4241,06N,tx,06N_tx_138,24338441,24339808,24339371,1367
4242,06N,tx,06N_tx_139,24355432,24355688,24355688,256
4243,06N,tx,06N_tx_140,24357181,24357489,24357489,308
4244,06N,tx,06N_tx_141,24374175,24378281,24375885,4106
4245,06N,tx,06N_tx_142,24388055,24392470,24391934,4415
4246,06N,tx,06N_tx_143,24423519,24424144,24423519,625
4247,06N,tx,06N_tx_144,24427943,24428784,24427943,841
4248,06N,tx,06N_tx_145,24430506,24433253,24430928,2747
4249,06N,tx,06N_tx_146,24435785,24437423,24435785,1638
4250,06N,tx,06N_tx_147,24442255,24444168,24442399,1913
4251,06N,tx,06N_tx_148,24446494,24446584,24446584,90
4252,06N,tx,06N_tx_149,24459375,24459533,24459381,158
4253,06N,tx,06N_tx_150,24462630,24465718,24464364,3088
4254,06N,tx,06N_tx_151,24468751,24469858,24468751,1107
4255,06N,tx,06N_tx_152,24471348,24472060,24471348,712
4256,06N,tx,06N_tx_153,24528040,24528085,24528040,45
4257,06N,tx,06N_tx_154,24677568,24679702,24677568,2134
4258,06N,tx,06N_tx_155,24694203,24696882,24696882,2679
4259,06N,tx,06N_tx_156,24699575,24701273,24701273,1698
4260,06N,tx,06N_tx_157,24708744,24709129,24709129,385
4261,06N,tx,06N_tx_158,24712986,24713451,24713451,465
4262,06N,tx,06N_tx_159,24716721,24717460,24717460,739
4263,06N,tx,06N_tx_160,24723398,24723449,24723416,51
4264,06N,tx,06N_tx_161,24729657,24731735,24730764,2078
4265,06N,tx,06N_tx_162,24733205,24733467,24733205,262
4266,06N,tx,06N_tx_163,24739468,24739660,24739660,192
4267,06N,tx,06N_tx_164,24740921,24743493,24740921,2572
4268,06N,tx,06N_tx_165,24759991,24760323,24759991,332
4269,06N,tx,06N_tx_166,24801940,24802253,24801940,313
4270,06N,tx,06N_tx_167,24820440,24827335,24824160,6895
4271,06N,tx,06N_tx_168,24829038,24829070,24829070,32
4272,06N,tx,06N_tx_169,24829632,24829747,24829747,115
4273,06N,tx,06N_tx_170,24830272,24832557,24830395,2285
4274,06N,tx,06N_tx_171,24833970,24836573,24834246,2603
4275,06N,tx,06N_tx_172,24841399,24841497,24841399,98
4276,06N,tx,06N_tx_173,24847808,24848165,24848165,357
4277,06N,tx,06N_tx_174,24857789,24860957,24860957,3168
4278,06N,tx,06N_tx_175,24862115,24866082,24864078,3967
4279,06N,tx,06N_tx_176,24866717,24867082,24866717,365
4280,06N,tx,06N_tx_177,24889500,24889678,24889500,178
4281,06N,tx,06N_tx_178,24897508,24898194,24897508,686
4282,06N,tx,06N_tx_179,24918940,24919213,24918940,273
4283,06N,tx,06N_tx_180,24920722,24921485,24921485,763
4284,06N,tx,06N_tx_181,24957632,24958462,24957632,830
4285,06N,tx,06N_tx_182,25298419,25298781,25298451,362
4286,06N,tx,06N_tx_183,25300040,25300101,25300040,61
4287,06N,tx,06N_tx_184,25300885,25301678,25301678,793
4288,06N,tx,06N_tx_185,25309162,25309828,25309828,666
4289,06N,tx,06N_tx_186,25327468,25329789,25328773,2321
4290,06N,tx,06N_tx_187,25331986,25332720,25332719,734
4291,06N,tx,06N_tx_188,25335546,25350822,25335876,15276
4292,06N,tx,06N_tx_189,25403836,25404062,25403836,226
4293,06N,tx,06N_tx_190,25405129,25405726,25405129,597
4294,06N,tx,06N_tx_191,25411157,25413145,25412223,1988
4295,06N,tx,06N_tx_192,25413913,25414349,25414349,436
4296,06N,tx,06N_tx_193,25432071,25432279,25432071,208
4297,06N,tx,06N_tx_194,25433052,25433680,25433345,628
4298,06N,tx,06N_tx_195,25448936,25449547,25449061,611
4299,06N,tx,06N_tx_196,25451513,25451762,25451513,249
4300,06N,tx,06N_tx_197,25452537,25455012,25453747,2475
4301,06N,tx,06N_tx_198,25455994,25457363,25456871,1369
4302,06N,tx,06N_tx_199,25458546,25458711,25458546,165
4303,06N,tx,06N_tx_200,25459560,25459939,25459939,379
4304,06N,tx,06N_tx_201,25461071,25461072,25461071,1
4305,06N,tx,06N_tx_202,25475008,25476001,25475518,993
4306,06N,tx,06N_tx_203,25476886,25477154,25476978,268
4307,06N,tx,06N_tx_204,25491637,25492946,25492946,1309
4308,06N,tx,06N_tx_205,25495126,25495127,25495126,1
4309,06N,tx,06N_tx_206,25496414,25496542,25496542,128
4310,06N,tx,06N_tx_207,25502934,25505157,25504393,2223
4311,06N,tx,06N_tx_208,25508265,25508449,25508449,184
4312,06N,tx,06N_tx_209,25511950,25513264,25513264,1314
4313,06N,tx,06N_tx_210,25516376,25516474,25516376,98
4314,06N,tx,06N_tx_211,25517435,25519518,25518436,2083
4315,06N,tx,06N_tx_212,25520387,25520574,25520440,187
4316,06N,tx,06N_tx_213,25520988,25521647,25521106,659
4317,06N,tx,06N_tx_214,25535774,25536121,25535785,347
4318,06N,tx,06N_tx_215,25537968,25538196,25538196,228
4319,06N,tx,06N_tx_216,25539882,25543638,25543546,3756
4320,06N,tx,06N_tx_217,25550572,25550698,25550572,126
4321,06N,tx,06N_tx_218,25560944,25562361,25561689,1417
4322,06N,tx,06N_tx_219,25565286,25566212,25566212,926
4323,06N,tx,06N_tx_220,25569421,25570835,25570490,1414
4324,06N,tx,06N_tx_221,25581599,25582165,25581599,566
4325,06N,tx,06N_tx_222,25588465,25588813,25588813,348
4326,06N,tx,06N_tx_223,25590899,25591241,25590899,342
4327,06N,tx,06N_tx_224,25597795,25599937,25597795,2142
4328,06N,tx,06N_tx_225,25601108,25602368,25601118,1260
4329,06N,tx,06N_tx_226,25603195,25603409,25603195,214
4330,06N,tx,06N_tx_227,25608039,25611236,25610242,3197
4331,06N,tx,06N_tx_228,25615769,25615881,25615769,112
4332,06N,tx,06N_tx_229,25639837,25640949,25640949,1112
4333,06N,tx,06N_tx_230,25641979,25644385,25644385,2406
4334,06N,tx,06N_tx_231,25654038,25655850,25655218,1812
4335,06N,tx,06N_tx_232,25656990,25657062,25657062,72
4336,06N,tx,06N_tx_233,25657606,25657717,25657606,111
4337,06N,tx,06N_tx_234,25658460,25660004,25658460,1544
4338,06N,tx,06N_tx_235,25660778,25662234,25662032,1456
4339,06N,tx,06N_tx_236,25664439,25668412,25664879,3973
4340,06N,tx,06N_tx_237,25709634,25711120,25709634,1486
4341,06N,tx,06N_tx_238,25711865,25715102,25715102,3237
4342,06N,tx,06N_tx_239,25717962,25718310,25717962,348
4343,06N,tx,06N_tx_240,25719932,25725080,25719932,5148
4344,06N,tx,06N_tx_241,25729795,25735968,25735968,6173
4345,06N,tx,06N_tx_242,25736538,25736910,25736538,372
4346,06N,tx,06N_tx_243,25738884,25739712,25738884,828
4347,06N,tx,06N_tx_244,25741602,25741792,25741606,190
4348,06N,tx,06N_tx_245,25762670,25764790,25763153,2120
4349,06N,tx,06N_tx_246,25794068,25794432,25794432,364
4350,06N,tx,06N_tx_247,25795799,25797709,25797341,1910
4351,06N,tx,06N_tx_248,25798702,25798835,25798702,133
4352,06N,tx,06N_tx_249,25800023,25801469,25800326,1446
4353,06N,tx,06N_tx_250,25802528,25803824,25802528,1296
4354,06N,tx,06N_tx_251,25805190,25805750,25805190,560
4355,06N,tx,06N_tx_252,25915212,25915687,25915687,475
4356,06N,tx,06N_tx_253,25916916,25918035,25918035,1119
4357,06N,tx,06N_tx_254,25919709,25920886,25919709,1177
4358,06N,tx,06N_tx_255,25921957,25922243,25921957,286
4359,06N,tx,06N_tx_256,25923044,25923121,25923121,77
4360,06N,tx,06N_tx_257,25955776,25956183,25956183,407
4361,06N,tx,06N_tx_258,25970426,25970605,25970605,179
4362,06N,tx,06N_tx_259,25972179,25973423,25972988,1244
4363,06N,tx,06N_tx_260,26074429,26077094,26076682,2665
4364,06N,tx,06N_tx_261,26078756,26079774,26079774,1018
4365,06N,tx,06N_tx_262,26081418,26083278,26083278,1860
4366,06N,tx,06N_tx_263,26086163,26086624,26086624,461
4367,06N,tx,06N_tx_264,26092904,26092906,26092904,2
4368,06N,tx,06N_tx_265,26103652,26107122,26107122,3470
4369,06N,tx,06N_tx_266,26108057,26109085,26108057,1028
4370,06N,tx,06N_tx_267,26111093,26112991,26111766,1898
4371,06N,tx,06N_tx_268,26113698,26114951,26114951,1253
4372,06N,tx,06N_tx_269,26116794,26120250,26119432,3456
4373,06N,tx,06N_tx_270,26121238,26123021,26121238,1783
4374,06N,tx,06N_tx_271,26127879,26129467,26127879,1588
4375,06N,tx,06N_tx_272,26130609,26130865,26130865,256
4376,06N,tx,06N_tx_273,26131974,26132611,26132611,637
4377,06N,tx,06N_tx_274,26133231,26134022,26133962,791
4378,06N,tx,06N_tx_275,26134708,26135032,26134708,324
4379,06N,tx,06N_tx_276,26137711,26137830,26137828,119
4380,06N,tx,06N_tx_277,26140272,26140603,26140272,331
4381,06N,tx,06N_tx_278,26142982,26144347,26142982,1365
4382,06N,tx,06N_tx_279,26146345,26149614,26148293,3269
4383,06N,tx,06N_tx_280,26156046,26156968,26156968,922
4384,06N,tx,06N_tx_281,26159081,26161175,26160529,2094
4385,06N,tx,06N_tx_282,26163173,26163407,26163407,234
4386,06N,tx,06N_tx_283,26177532,26178079,26177766,547
4387,06N,tx,06N_tx_284,26186585,26188224,26187438,1639
4388,06N,tx,06N_tx_285,26210685,26212467,26210685,1782
4389,06N,tx,06N_tx_286,26217592,26219439,26217789,1847
4390,06N,tx,06N_tx_287,28878201,28879149,28878201,948
4391,06N,tx,06N_tx_288,28973588,28974122,28973588,534
4392,06N,tx,06N_tx_289,30059374,30059860,30059860,486
4393,06N,tx,06N_tx_290,30095550,30104204,30095550,8654
4394,06N,tx,06N_tx_291,30181496,30181745,30181745,249
4395,06N,tx,06N_tx_292,30232777,30233807,30233420,1030
4396,06N,tx,06N_tx_293,30238796,30240275,30239993,1479
4397,06N,tx,06N_tx_294,30243362,30243938,30243938,576
4398,06N,tx,06N_tx_295,30263474,30264289,30263474,815
4399,06N,tx,06N_tx_296,30267703,30267878,30267703,175
4400,06N,tx,06N_tx_297,49127217,49127312,49127312,95
4401,07K,tx,07K_tx_1,25043381,25043654,25043452,273
4402,07K,tx,07K_tx_2,25055086,25059768,25059768,4682
4403,07K,tx,07K_tx_3,40527747,40527961,40527747,214
4404,07K,tx,07K_tx_4,41491634,41491876,41491876,242
4405,07N,tx,07N_tx_1,43376352,43376622,43376352,270
4406,09K,tx,09K_tx_1,16864513,16864720,16864513,207
4407,09K,tx,09K_tx_2,17715118,17715238,17715238,120
4408,09K,tx,09K_tx_3,18083139,18083162,18083139,23
4409,09K,tx,09K_tx_4,44161917,44162054,44162054,137
4410,09K,tx,09K_tx_5,44190069,44190103,44190069,34
4411,09N,tx,09N_tx_1,16893879,16894326,16893879,447
4412,09N,tx,09N_tx_2,52122229,52122777,52122229,548
4413,09N,tx,09N_tx_3,54258038,54258088,54258088,50
4414,09N,tx,09N_tx_4,67519454,67519725,67519725,271
4415,09N,tx,09N_tx_5,69240956,69241326,69240956,370
4416,09N,tx,09N_tx_6,70554397,70554515,70554397,118
4417,09N,tx,09N_tx_7,73818067,73818684,73818067,617
4418,09N,tx,09N_tx_8,73869671,73870739,73870739,1068
4419,09N,tx,09N_tx_9,73949644,73949757,73949757,113
4420,09N,tx,09N_tx_10,74186655,74187747,74186655,1092
4421,09N,tx,09N_tx_11,75248137,75248237,75248237,100
4422,09N,tx,09N_tx_12,75249967,75250308,75249967,341
4423,09N,tx,09N_tx_13,75254741,75257398,75256229,2657
4424,09N,tx,09N_tx_14,75741400,75742258,75742258,858
